Entered At,Exited At,Symbol,Type,Expiration,DTE,Short Strike,Long Strike,Quantity,Entry Price,Bid at Entry,Ask at Entry,Exit Price,Bid at Exit,Ask at Exit,Profit,Broker Fee,Risk,ROC,Assigned,Starting Balance,Ending Balance,PM Settled,Delta,IV,SPX at Entry,SPX at Exit,VIX at Entry,VIX at Exit
1/9/2016 9:31,2/9/2016 16:00,SPXW,Put,2/9/2016 0:00,1,2115,1815,17,-0.23,0.2,0.35,0,,,357,34,510000,0.0007,No,500000,500357,Yes,-0.0266,0.2283,2171.08,2179.98,13.49,11.92
2/9/2016 15:30,6/9/2016 16:00,SPXW,Put,6/9/2016 0:00,4,2125,1825,17,-0.28,0.25,0.4,0,,,442,34,510000,0.000866667,No,500357,500799,Yes,-0.0302,0.1296,2179.77,2186.48,12.08,12.01
6/9/2016 15:30,7/9/2016 16:00,SPXW,Put,7/9/2016 0:00,1,2145,1850,17,-0.13,0.1,0.25,0,,,187,34,501500,0.000372881,No,500799,500986,Yes,-0.0264,0.1701,2183.47,2186.16,12.19,11.89
7/9/2016 15:30,9/9/2016 16:00,SPXW,Put,9/9/2016 0:00,2,2135,1835,17,-0.23,0.2,0.35,7.19,,,-11866,34,510000,-0.023266667,Yes,500986,489120,Yes,-0.029,0.1634,2185.2,2127.81,11.96,17.14
9/9/2016 15:30,12/9/2016 16:00,SPXW,Put,12/9/2016 0:00,3,2050,1750,16,-0.53,0.45,0.7,0,,,816,32,480000,0.0017,No,489120,489936,Yes,-0.0312,0.251,2139.62,2159.04,16.38,15.04
12/9/2016 15:30,14/9/2016 16:00,SPXW,Put,14/9/2016 0:00,2,2080,1775,16,-0.41,0.35,0.55,0,,,624,32,488000,0.001278689,No,489936,490560,Yes,-0.0287,0.2639,2159.63,2125.77,15.08,17.66
14/9/2016 15:30,16/9/2016 9:30,SPX,Put,16/9/2016 0:00,2,2050,1750,16,-0.33,0.1,0.65,0,,,496,32,480000,0.001033333,No,490560,491056,No,-0.0281,0.2513,2119.93,2146.48,18.08,16.57
16/9/2016 9:31,19/9/2016 16:00,SPXW,Put,19/9/2016 0:00,3,2070,1775,17,-0.34,0.25,0.5,0,,,544,34,501500,0.001084746,No,491056,491600,Yes,-0.0293,0.1842,2143.14,2139.12,16.57,15.61
19/9/2016 15:30,21/9/2016 16:00,SPXW,Put,21/9/2016 0:00,2,2070,1775,17,-0.36,0.3,0.5,0,,,578,34,501500,0.001152542,No,491600,492178,Yes,-0.0288,0.2378,2141.33,2163.12,15.44,13.17
21/9/2016 15:30,23/9/2016 16:00,SPXW,Put,23/9/2016 0:00,2,2090,1790,16,-0.41,0.35,0.55,0,,,624,32,480000,0.0013,No,492178,492802,Yes,-0.032,0.2339,2158.63,2164.69,13.52,12.28
23/9/2016 15:30,26/9/2016 16:00,SPXW,Put,26/9/2016 0:00,3,2115,1825,17,-0.26,0.2,0.4,0,,,408,34,493000,0.000827586,No,492802,493210,Yes,-0.0291,0.1456,2168.69,2146.1,12.16,14.63
26/9/2016 15:30,28/9/2016 16:00,SPXW,Put,28/9/2016 0:00,2,2065,1775,17,-0.41,0.4,0.5,0,,,663,34,493000,0.001344828,No,493210,493873,Yes,-0.0277,0.2763,2148.73,2171.37,14.42,12.31
28/9/2016 15:30,30/9/2016 16:00,SPXW,Put,30/9/2016 0:00,2,2105,1805,16,-0.33,0.3,0.45,0,,,496,32,480000,0.001033333,No,493873,494369,Yes,-0.0305,0.2071,2166.78,2168.27,12.68,13.29
30/9/2016 15:30,3/10/2016 16:00,SPXW,Put,3/10/2016 0:00,3,2120,1820,16,-0.23,0.2,0.35,0,,,336,32,480000,0.0007,No,494369,494705,Yes,-0.0275,0.1429,2173.63,2161.2,12.74,13.64
3/10/2016 15:30,5/10/2016 16:00,SPXW,Put,5/10/2016 0:00,2,2105,1800,16,-0.23,0.2,0.35,0,,,336,32,488000,0.000688525,No,494705,495041,Yes,-0.0279,0.1732,2158.88,2159.73,13.76,13.04
5/10/2016 15:30,7/10/2016 16:00,SPXW,Put,7/10/2016 0:00,2,2105,1805,17,-0.28,0.25,0.4,0,,,442,34,510000,0.000866667,No,495041,495483,Yes,-0.0305,0.1824,2159.44,2153.74,13.02,13.41
7/10/2016 15:30,10/10/2016 16:00,SPXW,Put,10/10/2016 0:00,3,2110,1800,16,-0.26,0.2,0.4,0,,,384,32,496000,0.000774194,No,495483,495867,Yes,-0.0326,0.1288,2155.97,2163.66,13.35,13.44
10/10/2016 15:30,12/10/2016 16:00,SPXW,Put,12/10/2016 0:00,2,2120,1820,17,-0.21,0.2,0.3,0,,,323,34,510000,0.000633333,No,495867,496190,Yes,-0.0296,0.1477,2164.58,2139.18,13.41,15.74
12/10/2016 15:30,14/10/2016 16:00,SPXW,Put,14/10/2016 0:00,2,2085,1780,16,-0.28,0.25,0.4,0,,,416,32,488000,0.000852459,No,496190,496606,Yes,-0.0301,0.1863,2139.95,2132.98,15.62,16.01
14/10/2016 15:30,17/10/2016 16:00,SPXW,Put,17/10/2016 0:00,3,2090,1800,17,-0.21,0.15,0.35,0,,,323,34,493000,0.000655172,No,496606,496929,Yes,-0.0289,0.126,2135.84,2126.5,15.92,16.31
17/10/2016 15:30,19/10/2016 16:00,SPXW,Put,19/10/2016 0:00,2,2075,1775,17,-0.28,0.25,0.4,0,,,442,34,510000,0.000866667,No,496929,497371,Yes,-0.0315,0.178,2126.9,2144.29,16.39,14.39
19/10/2016 15:30,21/10/2016 9:30,SPX,Put,21/10/2016 0:00,2,2100,1800,17,-0.26,0.2,0.4,0,,,408,34,510000,0.0008,No,497371,497779,No,-0.0321,0.1735,2146.9,2139.43,14.23,14.05
21/10/2016 9:31,24/10/2016 16:00,SPXW,Put,24/10/2016 0:00,3,2085,1775,16,-0.23,0.15,0.4,0,,,336,32,496000,0.000677419,No,497779,498115,Yes,-0.0301,0.1266,2134.32,2151.33,14.05,12.97
24/10/2016 15:30,26/10/2016 16:00,SPXW,Put,26/10/2016 0:00,2,2105,1800,16,-0.23,0.2,0.35,0,,,336,32,488000,0.000688525,No,498115,498451,Yes,-0.031,0.1537,2150.49,2139.43,13.03,14.33
26/10/2016 15:30,28/10/2016 16:00,SPXW,Put,28/10/2016 0:00,2,2085,1780,16,-0.28,0.25,0.4,0,,,416,32,488000,0.000852459,No,498451,498867,Yes,-0.0301,0.1869,2140.3,2126.41,14.23,16.48
28/10/2016 15:30,31/10/2016 16:00,SPXW,Put,31/10/2016 0:00,3,2065,1760,16,-0.36,0.3,0.5,0,,,544,32,488000,0.001114754,No,498867,499411,Yes,-0.03,0.1866,2131.98,2126.15,16.29,17.3
31/10/2016 15:30,2/11/2016 16:00,SPXW,Put,2/11/2016 0:00,2,2065,1775,17,-0.38,0.35,0.5,0,,,612,34,493000,0.001241379,No,499411,500023,Yes,-0.0326,0.2198,2128.43,2097.94,17.33,19.15
2/11/2016 15:30,4/11/2016 16:00,SPXW,Put,4/11/2016 0:00,2,2045,1740,16,-0.31,0.25,0.45,0,,,464,32,488000,0.00095082,No,500023,500487,Yes,-0.0302,0.2024,2104.38,2085.18,18.69,22.91
9/11/2016 9:31,11/11/2016 16:00,SPXW,Put,11/11/2016 0:00,2,2010,1710,17,-0.64,0.35,1,0,,,1054,34,510000,0.002066667,No,500487,501541,Yes,-0.0286,0.3864,2133.74,2164.45,17.24,14.33
11/11/2016 15:30,14/11/2016 16:00,SPXW,Put,14/11/2016 0:00,3,2095,1800,17,-0.38,0.35,0.5,0,,,612,34,501500,0.001220339,No,501541,502153,Yes,-0.0318,0.1828,2160.62,2164.2,14.68,14.5
14/11/2016 15:30,16/11/2016 16:00,SPXW,Put,16/11/2016 0:00,2,2100,1800,17,-0.33,0.3,0.45,0,,,527,34,510000,0.001033333,No,502153,502680,Yes,-0.0293,0.2174,2166.28,2176.94,14.45,13.73
16/11/2016 15:30,18/11/2016 9:30,SPX,Put,18/11/2016 0:00,2,2120,1820,17,-0.26,0.1,0.5,0,,,408,34,510000,0.0008,No,502680,503088,No,-0.0298,0.2007,2176.42,2186.85,13.69,13.36
18/11/2016 9:31,21/11/2016 16:00,SPXW,Put,21/11/2016 0:00,3,2145,1840,16,-0.18,0.15,0.3,0,,,256,32,488000,0.00052459,No,503088,503344,Yes,-0.0282,0.1106,2187.93,2198.18,13.36,12.17
21/11/2016 15:30,23/11/2016 16:00,SPXW,Put,23/11/2016 0:00,2,2150,1850,17,-0.18,0.15,0.3,0,,,272,34,510000,0.000533333,No,503344,503616,Yes,-0.0272,0.1461,2195.91,2204.72,12.31,12.36
23/11/2016 15:30,25/11/2016 16:00,SPXW,Put,25/11/2016 0:00,2,2160,1860,17,-0.18,0.15,0.3,0,,,272,34,510000,0.000533333,No,503616,503888,Yes,-0.0289,0.1359,2202.16,2213.35,12.61,12.34
25/11/2016 15:30,28/11/2016 16:00,SPXW,Put,28/11/2016 0:00,3,2165,1860,17,-0.21,0,0.5,0,,,323,34,518500,0.000622951,No,503888,504211,Yes,-0.0278,0.1271,2213.35,2201.72,12.34,13.08
28/11/2016 15:30,30/11/2016 16:00,SPXW,Put,30/11/2016 0:00,2,2145,1845,17,-0.28,0.25,0.4,0,,,442,34,510000,0.000866667,No,504211,504653,Yes,-0.0294,0.1863,2202.69,2198.81,13.07,13.38
30/11/2016 15:30,2/12/2016 16:00,SPXW,Put,2/12/2016 0:00,2,2155,1855,17,-0.23,0.2,0.35,0,,,357,34,510000,0.0007,No,504653,505010,Yes,-0.0286,0.1646,2205.74,2191.95,12.97,14.12
2/12/2016 15:30,5/12/2016 16:00,SPXW,Put,5/12/2016 0:00,3,2110,1810,17,-0.46,0.4,0.6,0,,,748,34,510000,0.001466667,No,505010,505758,Yes,-0.0302,0.2228,2191.8,2204.71,14.04,12.24
5/12/2016 15:30,7/12/2016 16:00,SPXW,Put,7/12/2016 0:00,2,2160,1860,17,-0.21,0.2,0.3,0,,,323,34,510000,0.000633333,No,505758,506081,Yes,-0.0299,0.1438,2204.44,2241.35,12.44,12.07
7/12/2016 15:30,9/12/2016 16:00,SPXW,Put,9/12/2016 0:00,2,2185,1885,17,-0.28,0.25,0.4,0,,,442,34,510000,0.000866667,No,506081,506523,Yes,-0.0306,0.175,2238.95,2259.53,11.8,11.76
9/12/2016 15:30,12/12/2016 16:00,SPXW,Put,12/12/2016 0:00,3,2220,1920,17,-0.18,0.15,0.3,0,,,272,34,510000,0.000533333,No,506523,506795,Yes,-0.0302,0.103,2259.22,2256.96,11.87,12.66
12/12/2016 15:30,14/12/2016 16:00,SPXW,Put,14/12/2016 0:00,2,2190,1890,17,-0.31,0.3,0.4,0,,,493,34,510000,0.000966667,No,506795,507288,Yes,-0.028,0.2061,2255.13,2253.28,12.74,13.32
14/12/2016 15:30,16/12/2016 9:30,SPX,Put,16/12/2016 0:00,2,2185,1885,17,-0.36,0,0.8,0,,,578,34,510000,0.001133333,No,507288,507866,No,-0.0291,0.2407,2255,2266.81,13.16,12.79
16/12/2016 9:31,19/12/2016 16:00,SPXW,Put,19/12/2016 0:00,3,2205,1900,17,-0.33,0.25,0.5,0,,,527,34,518500,0.001016393,No,507866,508393,Yes,-0.0306,0.1558,2266.66,2262.53,12.79,11.7
19/12/2016 15:30,21/12/2016 16:00,SPXW,Put,21/12/2016 0:00,2,2215,1910,17,-0.18,0.15,0.3,0,,,272,34,518500,0.00052459,No,508393,508665,Yes,-0.0269,0.1434,2260.71,2265.18,11.86,11.27
21/12/2016 15:30,23/12/2016 16:00,SPXW,Put,23/12/2016 0:00,2,2225,1925,17,-0.16,0.15,0.25,0,,,238,34,510000,0.000466667,No,508665,508903,Yes,-0.0268,0.1292,2267.14,2263.79,11.38,11.5
23/12/2016 15:30,27/12/2016 16:00,SPXW,Put,27/12/2016 0:00,4,2215,1910,17,-0.23,0.2,0.35,0,,,357,34,518500,0.000688525,No,508903,509260,Yes,-0.0307,0.1055,2261.14,2268.88,11.62,11.94
27/12/2016 15:30,28/12/2016 16:00,SPXW,Put,28/12/2016 0:00,1,2240,1940,17,-0.13,0.1,0.25,0,,,187,34,510000,0.000366667,No,509260,509447,Yes,-0.0312,0.1353,2270.18,2249.92,11.9,12.91
28/12/2016 15:30,30/12/2016 16:00,SPXW,Put,30/12/2016 0:00,2,2195,1895,17,-0.28,0.25,0.4,0,,,442,34,510000,0.000866667,No,509447,509889,Yes,-0.0296,0.1806,2251.49,2238.83,12.94,14.07
3/1/2017 9:31,4/1/2017 16:00,SPXW,Put,4/1/2017 0:00,1,2205,1900,17,-0.26,0.2,0.4,0,,,408,34,518500,0.000786885,No,509889,510297,Yes,-0.0305,0.204,2255.92,2270.75,13.91,11.91
4/1/2017 15:30,6/1/2017 16:00,SPXW,Put,6/1/2017 0:00,2,2225,1925,17,-0.23,0.2,0.35,0,,,357,34,510000,0.0007,No,510297,510654,Yes,-0.0311,0.1455,2271.26,2276.98,11.79,11.4
6/1/2017 15:30,9/1/2017 16:00,SPXW,Put,9/1/2017 0:00,3,2235,1930,17,-0.18,0.15,0.3,0,,,272,34,518500,0.00052459,No,510654,510926,Yes,-0.028,0.1116,2278.56,2268.9,11.46,11.61
9/1/2017 15:30,11/1/2017 16:00,SPXW,Put,11/1/2017 0:00,2,2230,1930,17,-0.18,0.15,0.3,0,,,272,34,510000,0.000533333,No,510926,511198,Yes,-0.0286,0.1332,2272.44,2275.32,11.53,11.26
11/1/2017 15:30,13/1/2017 16:00,SPXW,Put,13/1/2017 0:00,2,2225,1925,17,-0.26,0.25,0.35,0,,,408,34,510000,0.0008,No,511198,511606,Yes,-0.0321,0.1518,2271.9,2274.64,11.41,11.41
13/1/2017 15:30,17/1/2017 16:00,SPXW,Put,17/1/2017 0:00,4,2225,1925,17,-0.23,0.2,0.35,0,,,357,34,510000,0.0007,No,511606,511963,Yes,-0.0294,0.1101,2274,2267.89,11.46,11.93
17/1/2017 15:30,18/1/2017 16:00,SPXW,Put,18/1/2017 0:00,1,2205,1900,17,-0.33,0.3,0.45,0,,,527,34,518500,0.001016393,No,511963,512490,Yes,-0.0316,0.2667,2264.15,2271.89,12.06,12.45
18/1/2017 15:30,20/1/2017 9:30,SPX,Put,20/1/2017 0:00,2,2205,1905,17,-0.36,0.2,0.6,0,,,578,34,510000,0.001133333,No,512490,513068,No,-0.0311,0.2224,2269.13,2269.96,12.53,12.66
20/1/2017 9:31,23/1/2017 16:00,SPXW,Put,23/1/2017 0:00,3,2195,1900,17,-0.41,0.35,0.55,0,,,663,34,501500,0.001322034,No,513068,513731,Yes,-0.0291,0.1947,2272.01,2265.2,12.66,11.85
23/1/2017 15:30,25/1/2017 16:00,SPXW,Put,25/1/2017 0:00,2,2210,1900,17,-0.28,0.25,0.4,0,,,442,34,527000,0.00083871,No,513731,514173,Yes,-0.0303,0.1751,2264.62,2298.37,12.01,10.7
25/1/2017 15:30,27/1/2017 16:00,SPXW,Put,27/1/2017 0:00,2,2255,1955,17,-0.23,0.2,0.35,0,,,357,34,510000,0.0007,No,514173,514530,Yes,-0.0328,0.1355,2297.21,2294.69,10.65,10.47
27/1/2017 15:30,30/1/2017 16:00,SPXW,Put,30/1/2017 0:00,3,2250,1950,17,-0.21,0.2,0.3,0,,,323,34,510000,0.000633333,No,514530,514853,Yes,-0.031,0.1087,2291.67,2280.9,10.6,11.85
30/1/2017 15:30,31/1/2017 16:00,SPXW,Put,31/1/2017 0:00,1,2225,1925,17,-0.23,0.2,0.35,0,,,357,34,510000,0.0007,No,514853,515210,Yes,-0.0289,0.2208,2274.94,2278.87,12.08,12.06
31/1/2017 15:30,1/2/2017 16:00,SPXW,Put,1/2/2017 0:00,1,2230,1930,17,-0.23,0.2,0.35,0,,,357,34,510000,0.0007,No,515210,515567,Yes,-0.0311,0.2027,2275.6,2279.55,12.35,11.7
1/2/2017 15:30,3/2/2017 16:00,SPXW,Put,3/2/2017 0:00,2,2215,1915,17,-0.33,0.3,0.45,0,,,527,34,510000,0.001033333,No,515567,516094,Yes,-0.0295,0.2049,2279.96,2297.42,11.62,10.78
3/2/2017 15:30,6/2/2017 16:00,SPXW,Put,6/2/2017 0:00,3,2250,1950,17,-0.23,0.2,0.35,0,,,357,34,510000,0.0007,No,516094,516451,Yes,-0.0306,0.1201,2296.47,2292.56,10.82,11.26
6/2/2017 15:30,8/2/2017 16:00,SPXW,Put,8/2/2017 0:00,2,2235,1930,17,-0.28,0.25,0.4,0,,,442,34,518500,0.000852459,No,516451,516893,Yes,-0.03,0.1749,2291.23,2294.67,11.28,11.36
8/2/2017 15:30,10/2/2017 16:00,SPXW,Put,10/2/2017 0:00,2,2245,1945,17,-0.21,0.2,0.3,0,,,323,34,510000,0.000633333,No,516893,517216,Yes,-0.0273,0.1528,2295.29,2316.1,11.33,10.88
10/2/2017 15:30,13/2/2017 16:00,SPXW,Put,13/2/2017 0:00,3,2275,1975,17,-0.21,0.15,0.35,0,,,323,34,510000,0.000633333,No,517216,517539,Yes,-0.0314,0.1056,2316.66,2328.25,10.84,11.15
13/2/2017 15:30,15/2/2017 16:00,SPXW,Put,15/2/2017 0:00,2,2270,1970,17,-0.28,0.25,0.4,0,,,442,34,510000,0.000866667,No,517539,517981,Yes,-0.029,0.179,2328.58,2349.25,11.17,11.97
15/2/2017 15:30,17/2/2017 9:30,SPX,Put,17/2/2017 0:00,2,2285,1985,17,-0.36,0.25,0.55,0,,,578,34,510000,0.001133333,No,517981,518559,No,-0.0317,0.2223,2349.96,2343.01,11.68,11.9
17/2/2017 9:31,21/2/2017 16:00,SPXW,Put,21/2/2017 0:00,4,2270,1970,17,-0.36,0.3,0.5,0,,,578,34,510000,0.001133333,No,518559,519137,Yes,-0.0286,0.1513,2341.28,2365.38,11.9,11.58
21/2/2017 15:30,22/2/2017 16:00,SPXW,Put,22/2/2017 0:00,1,2335,2030,17,-0.11,0.1,0.2,0,,,153,34,518500,0.000295082,No,519137,519290,Yes,-0.0281,0.1281,2365.57,2362.82,11.61,11.72
22/2/2017 15:30,24/2/2017 16:00,SPXW,Put,24/2/2017 0:00,2,2320,2020,17,-0.18,0.15,0.3,0,,,272,34,510000,0.000533333,No,519290,519562,Yes,-0.0285,0.1286,2363.59,2367.34,11.71,11.34
24/2/2017 15:30,27/2/2017 16:00,SPXW,Put,27/2/2017 0:00,3,2320,2020,17,-0.21,0.15,0.35,0,,,323,34,510000,0.000633333,No,519562,519885,Yes,-0.0314,0.1039,2361.2,2369.75,11.38,12.06
27/2/2017 15:30,28/2/2017 16:00,SPXW,Put,28/2/2017 0:00,1,2335,2035,17,-0.18,0.15,0.3,0,,,272,34,510000,0.000533333,No,519885,520157,Yes,-0.0323,0.1557,2371.03,2363.64,11.97,12.82
28/2/2017 15:30,1/3/2017 16:00,SPXW,Put,1/3/2017 0:00,1,2315,2010,17,-0.23,0.2,0.35,0,,,357,34,518500,0.000688525,No,520157,520514,Yes,-0.0301,0.2029,2362.79,2395.96,12.78,12.35
1/3/2017 15:30,3/3/2017 16:00,SPXW,Put,3/3/2017 0:00,2,2345,2045,17,-0.26,0.2,0.4,0,,,408,34,510000,0.0008,No,520514,520922,Yes,-0.0291,0.1608,2398.24,2383.12,12.21,11
3/3/2017 15:30,6/3/2017 16:00,SPXW,Put,6/3/2017 0:00,3,2345,2040,17,-0.13,0.1,0.25,0,,,187,34,518500,0.000360656,No,520922,521109,Yes,-0.0266,0.0907,2382.74,2375.31,11.09,11.19
6/3/2017 15:30,8/3/2017 16:00,SPXW,Put,8/3/2017 0:00,2,2335,2030,17,-0.18,0.15,0.3,0,,,272,34,518500,0.00052459,No,521109,521381,Yes,-0.0292,0.1243,2376.71,2362.98,11.1,11.74
8/3/2017 15:30,10/3/2017 16:00,SPXW,Put,10/3/2017 0:00,2,2315,2015,17,-0.23,0.2,0.35,0,,,357,34,510000,0.0007,No,521381,521738,Yes,-0.0285,0.154,2365.72,2372.6,11.56,11.53
10/3/2017 15:30,13/3/2017 16:00,SPXW,Put,13/3/2017 0:00,3,2320,2020,17,-0.28,0.25,0.4,0,,,442,34,510000,0.000866667,No,521738,522180,Yes,-0.0315,0.131,2372.67,2373.47,11.51,11.29
13/3/2017 15:30,15/3/2017 16:00,SPXW,Put,15/3/2017 0:00,2,2300,2000,17,-0.43,0.4,0.55,0,,,697,34,510000,0.001366667,No,522180,522877,Yes,-0.0319,0.2251,2372.25,2385.26,11.41,11.48
15/3/2017 15:30,17/3/2017 9:30,SPX,Put,17/3/2017 0:00,2,2325,2025,17,-0.26,0.15,0.45,0,,,408,34,510000,0.0008,No,522877,523285,No,-0.0263,0.1953,2386.97,2383.71,11.27,11.09
17/3/2017 9:31,20/3/2017 16:00,SPXW,Put,20/3/2017 0:00,3,2320,2020,17,-0.34,0.25,0.5,0,,,544,34,510000,0.001066667,No,523285,523829,Yes,-0.0312,0.1536,2382.99,2373.47,11.09,11.35
20/3/2017 15:30,22/3/2017 16:00,SPXW,Put,22/3/2017 0:00,2,2315,2010,17,-0.33,0.3,0.45,0,,,527,34,518500,0.001016393,No,523829,524356,Yes,-0.0311,0.1849,2375.24,2348.45,11.26,12.65
22/3/2017 15:30,24/3/2017 16:00,SPXW,Put,24/3/2017 0:00,2,2255,1955,17,-0.51,0.5,0.6,0,,,833,34,510000,0.001633333,No,524356,525189,Yes,-0.0289,0.2912,2349.3,2343.98,12.44,13
27/3/2017 9:31,29/3/2017 16:00,SPXW,Put,29/3/2017 0:00,2,2230,1925,17,-0.49,0.4,0.65,0,,,799,34,518500,0.001540984,No,525189,525988,Yes,-0.0293,0.2738,2322.77,2361.13,13.81,11.4
29/3/2017 15:30,31/3/2017 16:00,SPXW,Put,31/3/2017 0:00,2,2305,2005,18,-0.28,0.25,0.4,0,,,468,36,540000,0.000866667,No,525988,526456,Yes,-0.0292,0.1751,2362.69,2362.72,11.26,12.25
31/3/2017 15:30,3/4/2017 16:00,SPXW,Put,3/4/2017 0:00,3,2310,2000,17,-0.31,0.25,0.45,0,,,493,34,527000,0.000935484,No,526456,526949,Yes,-0.0309,0.1437,2367.19,2358.84,12.24,12.36
3/4/2017 15:30,5/4/2017 16:00,SPXW,Put,5/4/2017 0:00,2,2315,2020,18,-0.23,0.2,0.35,0,,,378,36,531000,0.000711864,No,526949,527327,Yes,-0.032,0.1356,2359.1,2352.95,12.48,12.51
5/4/2017 15:30,7/4/2017 16:00,SPXW,Put,7/4/2017 0:00,2,2290,1990,18,-0.36,0.35,0.45,0,,,612,36,540000,0.001133333,No,527327,527939,Yes,-0.03,0.2063,2357.65,2355.54,12.15,12.88
7/4/2017 15:30,10/4/2017 16:00,SPXW,Put,10/4/2017 0:00,3,2305,2000,17,-0.28,0.25,0.4,0,,,442,34,518500,0.000852459,No,527939,528381,Yes,-0.0311,0.1337,2357.98,2357.16,12.9,13.93
10/4/2017 15:30,12/4/2017 16:00,SPXW,Put,12/4/2017 0:00,2,2305,2000,17,-0.28,0.25,0.4,0,,,442,34,518500,0.000852459,No,528381,528823,Yes,-0.0307,0.1657,2358.99,2344.93,13.73,15.72
12/4/2017 15:30,13/4/2017 16:00,SPXW,Put,13/4/2017 0:00,1,2305,2005,18,-0.21,0.2,0.3,0,,,342,36,540000,0.000633333,No,528823,529165,Yes,-0.0319,0.1759,2344.85,2328.95,15.75,15.96
13/4/2017 15:30,17/4/2017 16:00,SPXW,Put,17/4/2017 0:00,4,2265,1975,18,-0.34,0.3,0.45,0,,,576,36,522000,0.001103448,No,529165,529741,Yes,-0.0292,0.1525,2334.47,2349.01,15.88,14.63
17/4/2017 15:30,19/4/2017 16:00,SPXW,Put,19/4/2017 0:00,2,2295,2000,18,-0.23,0.2,0.35,0,,,378,36,531000,0.000711864,No,529741,530119,Yes,-0.028,0.1583,2347.32,2338.17,14.7,14.95
19/4/2017 15:30,21/4/2017 9:30,SPX,Put,21/4/2017 0:00,2,2280,1980,18,-0.26,0.15,0.45,0,,,432,36,540000,0.0008,No,530119,530551,No,-0.0295,0.1887,2336.95,2354.74,14.8,14.16
21/4/2017 9:31,24/4/2017 16:00,SPXW,Put,24/4/2017 0:00,3,2235,1925,17,-0.66,0.45,0.95,0,,,1088,34,527000,0.002064516,No,530551,531639,Yes,-0.0292,0.2946,2355.07,2374.15,14.16,10.89
24/4/2017 15:30,26/4/2017 16:00,SPXW,Put,26/4/2017 0:00,2,2315,2010,17,-0.33,0.3,0.45,0,,,527,34,518500,0.001016393,No,531639,532166,Yes,-0.0308,0.1871,2375.51,2387.45,11.07,10.73
26/4/2017 15:30,28/4/2017 16:00,SPXW,Put,28/4/2017 0:00,2,2335,2035,18,-0.29,0.2,0.45,0,,,486,36,540000,0.0009,No,532166,532652,Yes,-0.0303,0.1773,2393.71,2384.2,10.43,10.81
28/4/2017 15:30,1/5/2017 16:00,SPXW,Put,1/5/2017 0:00,3,2330,2030,18,-0.28,0.25,0.4,0,,,468,36,540000,0.000866667,No,532652,533120,Yes,-0.0306,0.135,2383.98,2388.33,11.02,10.12
1/5/2017 15:30,3/5/2017 16:00,SPXW,Put,3/5/2017 0:00,2,2345,2040,17,-0.23,0.2,0.35,0,,,357,34,518500,0.000688525,No,533120,533477,Yes,-0.0305,0.1414,2391.84,2388.13,10.24,10.66
3/5/2017 15:30,5/5/2017 16:00,SPXW,Put,5/5/2017 0:00,2,2340,2040,18,-0.23,0.2,0.35,0,,,378,36,540000,0.0007,No,533477,533855,Yes,-0.0306,0.1407,2386.57,2399.29,10.72,10.73
5/5/2017 15:30,8/5/2017 16:00,SPXW,Put,8/5/2017 0:00,3,2300,2000,18,-0.83,0.8,0.95,0,,,1458,36,540000,0.0027,No,533855,535313,Yes,-0.0397,0.2553,2395.6,2399.38,10.73,9.72
8/5/2017 15:30,10/5/2017 16:00,SPXW,Put,10/5/2017 0:00,2,2345,2040,18,-0.26,0.25,0.35,0,,,432,36,549000,0.000786885,No,535313,535745,Yes,-0.0299,0.1559,2397.88,2399.63,9.71,9.99
10/5/2017 15:30,12/5/2017 16:00,SPXW,Put,12/5/2017 0:00,2,2325,2025,18,-0.38,0.35,0.5,0,,,648,36,540000,0.0012,No,535745,536393,Yes,-0.0296,0.2179,2398.04,2390.9,10,10.37
12/5/2017 15:30,15/5/2017 16:00,SPXW,Put,15/5/2017 0:00,3,2315,2010,18,-0.38,0.35,0.5,0,,,648,36,549000,0.001180328,No,536393,537041,Yes,-0.0293,0.1813,2388.58,2402.32,10.49,10.28
15/5/2017 15:30,17/5/2017 16:00,SPXW,Put,17/5/2017 0:00,2,2340,2040,18,-0.33,0.3,0.45,0,,,558,36,540000,0.001033333,No,537041,537599,Yes,-0.0313,0.1816,2400.62,2357.03,10.4,15.43
17/5/2017 15:30,19/5/2017 16:00,SPXW,Put,19/5/2017 0:00,2,2240,1940,18,-0.69,0.6,0.85,0,,,1206,36,540000,0.002233333,No,537599,538805,Yes,-0.0293,0.3837,2364.1,2381.73,14.26,12.32
19/5/2017 15:30,22/5/2017 16:00,SPXW,Put,22/5/2017 0:00,3,2325,2025,18,-0.31,0.25,0.45,0,,,522,36,540000,0.000966667,No,538805,539327,Yes,-0.0314,0.1406,2380.84,2394.02,12.6,11.04
22/5/2017 15:30,24/5/2017 16:00,SPXW,Put,24/5/2017 0:00,2,2340,2050,19,-0.23,0.2,0.35,0,,,399,38,551000,0.000724138,No,539327,539726,Yes,-0.0275,0.1588,2393.29,2404.39,10.98,9.95
24/5/2017 15:30,26/5/2017 16:00,SPXW,Put,26/5/2017 0:00,2,2355,2055,18,-0.23,0.2,0.35,0,,,378,36,540000,0.0007,No,539726,540104,Yes,-0.0304,0.1412,2402.51,2415.82,10.11,9.77
26/5/2017 15:30,30/5/2017 16:00,SPXW,Put,30/5/2017 0:00,4,2375,2075,18,-0.16,0.1,0.3,0,,,252,36,540000,0.000466667,No,540104,540356,Yes,-0.028,0.0823,2414.78,2412.91,9.75,10.3
30/5/2017 15:30,31/5/2017 16:00,SPXW,Put,31/5/2017 0:00,1,2385,2085,18,-0.13,0.1,0.25,0,,,198,36,540000,0.000366667,No,540356,540554,Yes,-0.0327,0.121,2413.68,2411.8,10.29,10.66
31/5/2017 15:30,2/6/2017 16:00,SPXW,Put,2/6/2017 0:00,2,2350,2050,18,-0.28,0.25,0.4,0,,,468,36,540000,0.000866667,No,540554,541022,Yes,-0.0283,0.1777,2410.25,2439.07,10.83,9.78
2/6/2017 15:30,5/6/2017 16:00,SPXW,Put,5/6/2017 0:00,3,2405,2100,18,-0.18,0.15,0.3,0,,,288,36,549000,0.00052459,No,541022,541310,Yes,-0.0342,0.083,2438.38,2436.1,9.76,9.9
5/6/2017 15:30,7/6/2017 16:00,SPXW,Put,7/6/2017 0:00,2,2400,2100,18,-0.18,0.15,0.3,0,,,288,36,540000,0.000533333,No,541310,541598,Yes,-0.0312,0.1127,2437.98,2433.14,9.74,10.35
7/6/2017 15:30,9/6/2017 16:00,SPXW,Put,9/6/2017 0:00,2,2375,2075,18,-0.26,0.2,0.4,0,,,432,36,540000,0.0008,No,541598,542030,Yes,-0.0274,0.1698,2433.34,2431.77,10.3,10.73
9/6/2017 15:30,12/6/2017 16:00,SPXW,Put,12/6/2017 0:00,3,2355,2050,18,-0.41,0.3,0.6,0,,,702,36,549000,0.001278689,No,542030,542732,Yes,-0.0297,0.1853,2431.03,2429.39,10.95,11.42
12/6/2017 15:30,14/6/2017 16:00,SPXW,Put,14/6/2017 0:00,2,2355,2050,18,-0.41,0.35,0.55,0,,,702,36,549000,0.001278689,No,542732,543434,Yes,-0.0318,0.2099,2424.52,2437.92,11.69,10.54
14/6/2017 15:30,16/6/2017 16:00,SPXW,Put,16/6/2017 0:00,2,2360,2060,18,-0.38,0.35,0.5,0,,,648,36,540000,0.0012,No,543434,544082,Yes,-0.0293,0.2172,2433.62,2433.15,10.83,10.29
16/6/2017 15:30,19/6/2017 16:00,SPXW,Put,19/6/2017 0:00,3,2390,2100,19,-0.18,0.15,0.3,0,,,304,38,551000,0.000551724,No,544082,544386,Yes,-0.03,0.0967,2429.83,2453.46,10.71,10.28
19/6/2017 15:30,21/6/2017 16:00,SPXW,Put,21/6/2017 0:00,2,2405,2100,18,-0.18,0.15,0.3,0,,,288,36,549000,0.00052459,No,544386,544674,Yes,-0.0271,0.1315,2450.63,2435.61,10.3,10.8
21/6/2017 15:30,23/6/2017 16:00,SPXW,Put,23/6/2017 0:00,2,2385,2085,18,-0.28,0.25,0.4,0,,,468,36,540000,0.000866667,No,544674,545142,Yes,-0.0319,0.1534,2435.86,2438.3,10.82,9.9
23/6/2017 15:30,26/6/2017 16:00,SPXW,Put,26/6/2017 0:00,3,2390,2100,19,-0.23,0.2,0.35,0,,,399,38,551000,0.000724138,No,545142,545541,Yes,-0.0318,0.1084,2433.94,2439.07,10.22,9.89
26/6/2017 15:30,28/6/2017 16:00,SPXW,Put,28/6/2017 0:00,2,2395,2100,18,-0.23,0.2,0.35,0,,,378,36,531000,0.000711864,No,545541,545919,Yes,-0.0306,0.138,2441.46,2440.69,9.77,10.08
28/6/2017 15:30,30/6/2017 16:00,SPXW,Put,30/6/2017 0:00,2,2385,2085,18,-0.33,0.3,0.45,0,,,558,36,540000,0.001033333,No,545919,546477,Yes,-0.0322,0.1729,2442.24,2423.41,10.04,11.12
30/6/2017 15:30,3/7/2017 16:00,SPXW,Put,3/7/2017 0:00,3,2385,2075,18,-0.23,0.2,0.35,0,,,378,36,558000,0.000677419,No,546477,546855,Yes,-0.0311,0.1112,2430.52,2429.01,10.77,11.22
3/7/2017 15:30,5/7/2017 16:00,SPXW,Put,5/7/2017 0:00,2,2385,2075,18,-0.21,0.15,0.35,0,,,342,36,558000,0.000612903,No,546855,547197,Yes,-0.0311,0.1249,2429.01,2432.54,11.22,10.87
5/7/2017 15:30,7/7/2017 16:00,SPXW,Put,7/7/2017 0:00,2,2385,2085,18,-0.23,0.2,0.35,0,,,378,36,540000,0.0007,No,547197,547575,Yes,-0.0304,0.1392,2432.25,2425.18,10.97,11.13
7/7/2017 15:30,10/7/2017 16:00,SPXW,Put,10/7/2017 0:00,3,2390,2090,18,-0.13,0.1,0.25,0,,,198,36,540000,0.000366667,No,547575,547773,Yes,-0.0278,0.0846,2425.12,2427.43,11.12,11.05
10/7/2017 15:30,12/7/2017 16:00,SPXW,Put,12/7/2017 0:00,2,2385,2080,18,-0.18,0.15,0.3,0,,,288,36,549000,0.00052459,No,547773,548061,Yes,-0.0275,0.1303,2429.48,2443.25,10.97,10.19
12/7/2017 15:30,14/7/2017 16:00,SPXW,Put,14/7/2017 0:00,2,2400,2100,18,-0.21,0.2,0.3,0,,,342,36,540000,0.000633333,No,548061,548403,Yes,-0.0294,0.1322,2444.79,2459.27,10.21,9.67
14/7/2017 15:30,17/7/2017 16:00,SPXW,Put,17/7/2017 0:00,3,2425,2125,18,-0.13,0.1,0.25,0,,,198,36,540000,0.000366667,No,548403,548601,Yes,-0.0269,0.0864,2461.93,2459.14,9.53,9.92
17/7/2017 15:30,19/7/2017 16:00,SPXW,Put,19/7/2017 0:00,2,2410,2110,18,-0.23,0.2,0.35,0,,,378,36,540000,0.0007,No,548601,548979,Yes,-0.0297,0.1417,2458.21,2473.83,10.02,9.78
19/7/2017 15:30,21/7/2017 16:00,SPXW,Put,21/7/2017 0:00,2,2425,2125,18,-0.23,0.2,0.35,0,,,378,36,540000,0.0007,No,548979,549357,Yes,-0.0298,0.1403,2473.03,2472.54,9.7,9.32
21/7/2017 15:30,24/7/2017 16:00,SPXW,Put,24/7/2017 0:00,3,2430,2130,18,-0.18,0.15,0.3,0,,,288,36,540000,0.000533333,No,549357,549645,Yes,-0.0304,0.0938,2469.14,2469.91,9.59,9.4
24/7/2017 15:30,26/7/2017 16:00,SPXW,Put,26/7/2017 0:00,2,2435,2125,18,-0.18,0.15,0.3,0,,,288,36,558000,0.000516129,No,549645,549933,Yes,-0.031,0.1116,2472.78,2477.83,9.38,9.5
26/7/2017 15:30,28/7/2017 16:00,SPXW,Put,28/7/2017 0:00,2,2430,2130,18,-0.23,0.2,0.35,0,,,378,36,540000,0.0007,No,549933,550311,Yes,-0.03,0.1387,2477.97,2472.1,9.51,10.37
28/7/2017 15:30,31/7/2017 16:00,SPXW,Put,31/7/2017 0:00,3,2425,2125,18,-0.21,0.2,0.3,0,,,342,36,540000,0.000633333,No,550311,550653,Yes,-0.029,0.1086,2470.56,2470.3,10.5,10.52
31/7/2017 15:30,2/8/2017 16:00,SPXW,Put,2/8/2017 0:00,2,2425,2125,18,-0.28,0.25,0.4,0,,,468,36,540000,0.000866667,No,550653,551121,Yes,-0.033,0.1455,2473.9,2477.57,10.43,10.22
2/8/2017 15:30,4/8/2017 16:00,SPXW,Put,4/8/2017 0:00,2,2420,2120,18,-0.26,0.25,0.35,0,,,432,36,540000,0.0008,No,551121,551553,Yes,-0.0288,0.1577,2475.05,2476.83,10.22,10.01
4/8/2017 15:30,7/8/2017 16:00,SPXW,Put,7/8/2017 0:00,3,2430,2125,18,-0.23,0.2,0.35,0,,,378,36,549000,0.000688525,No,551553,551931,Yes,-0.0313,0.1085,2474.89,2480.91,9.88,9.87
7/8/2017 15:30,9/8/2017 16:00,SPXW,Put,9/8/2017 0:00,2,2425,2125,18,-0.28,0.25,0.4,0,,,468,36,540000,0.000866667,No,551931,552399,Yes,-0.03,0.1617,2480.83,2474.02,9.81,11.45
9/8/2017 15:30,11/8/2017 16:00,SPXW,Put,11/8/2017 0:00,2,2375,2075,18,-0.48,0.45,0.6,0,,,828,36,540000,0.001533333,No,552399,553227,Yes,-0.0282,0.2727,2469.45,2441.32,11.97,15.66
11/8/2017 15:30,14/8/2017 16:00,SPXW,Put,14/8/2017 0:00,3,2325,2025,18,-0.69,0.6,0.85,0,,,1206,36,540000,0.002233333,No,553227,554433,Yes,-0.0309,0.2866,2440.73,2465.84,16.3,12.29
14/8/2017 15:30,16/8/2017 16:00,SPXW,Put,16/8/2017 0:00,2,2395,2100,19,-0.36,0.35,0.45,0,,,646,38,560500,0.001152542,No,554433,555079,Yes,-0.0287,0.2073,2466.91,2468.11,12.3,11.84
16/8/2017 15:30,18/8/2017 16:00,SPXW,Put,18/8/2017 0:00,2,2410,2110,19,-0.33,0.3,0.45,0,,,589,38,570000,0.001033333,No,555079,555668,Yes,-0.0319,0.173,2468.25,2425.55,11.55,14.4
18/8/2017 15:30,21/8/2017 16:00,SPXW,Put,21/8/2017 0:00,3,2370,2075,19,-0.31,0.25,0.45,0,,,551,38,560500,0.000983051,No,555668,556219,Yes,-0.0298,0.146,2430.23,2428.37,14.35,13.19
21/8/2017 15:30,23/8/2017 16:00,SPXW,Put,23/8/2017 0:00,2,2365,2075,19,-0.31,0.3,0.4,0,,,551,38,551000,0.001,No,556219,556770,Yes,-0.0286,0.1867,2428.01,2444.04,13.37,11.92
23/8/2017 15:30,25/8/2017 16:00,SPXW,Put,25/8/2017 0:00,2,2400,2100,19,-0.23,0.2,0.35,0,,,399,38,570000,0.0007,No,556770,557169,Yes,-0.0302,0.1394,2447.09,2443.05,11.79,11.35
25/8/2017 15:30,28/8/2017 16:00,SPXW,Put,28/8/2017 0:00,3,2405,2100,18,-0.18,0.15,0.3,0,,,288,36,549000,0.00052459,No,557169,557457,Yes,-0.0282,0.1031,2448.49,2444.24,11.12,11.39
28/8/2017 15:30,30/8/2017 16:00,SPXW,Put,30/8/2017 0:00,2,2400,2100,19,-0.23,0.2,0.35,0,,,399,38,570000,0.0007,No,557457,557856,Yes,-0.033,0.1266,2442.42,2457.59,11.42,11.18
30/8/2017 15:30,31/8/2017 16:00,SPXW,Put,31/8/2017 0:00,1,2420,2120,19,-0.13,0.1,0.25,0,,,209,38,570000,0.000366667,No,557856,558065,Yes,-0.0261,0.1531,2458.9,2471.65,11.06,10.6
31/8/2017 15:30,1/9/2017 16:00,SPXW,Put,1/9/2017 0:00,1,2425,2125,19,-0.21,0.2,0.3,0,,,361,38,570000,0.000633333,No,558065,558426,Yes,-0.0283,0.1905,2472.84,2476.55,10.44,10.19
1/9/2017 15:30,5/9/2017 16:00,SPXW,Put,5/9/2017 0:00,4,2425,2125,19,-0.23,0.2,0.35,0,,,399,38,570000,0.0007,No,558426,558825,Yes,-0.0274,0.1093,2479.04,2457.85,10.05,12.63
5/9/2017 15:30,6/9/2017 16:00,SPXW,Put,6/9/2017 0:00,1,2410,2110,19,-0.18,0.15,0.3,0,,,304,38,570000,0.000533333,No,558825,559129,Yes,-0.0262,0.1904,2457.71,2465.54,12.91,11.61
6/9/2017 15:30,8/9/2017 16:00,SPXW,Put,8/9/2017 0:00,2,2415,2115,19,-0.31,0.3,0.4,0,,,551,38,570000,0.000966667,No,559129,559680,Yes,-0.0322,0.1604,2469.21,2461.43,11.41,12.34
8/9/2017 15:30,11/9/2017 16:00,SPXW,Put,11/9/2017 0:00,3,2385,2090,19,-0.43,0.4,0.55,0,,,779,38,560500,0.001389831,No,559680,560459,Yes,-0.0308,0.185,2461.21,2488.11,12.46,10.78
11/9/2017 15:30,13/9/2017 16:00,SPXW,Put,13/9/2017 0:00,2,2430,2130,19,-0.28,0.25,0.4,0,,,494,38,570000,0.000866667,No,560459,560953,Yes,-0.0293,0.1658,2487.37,2498.37,10.74,10.4
13/9/2017 15:30,15/9/2017 16:00,SPXW,Put,15/9/2017 0:00,2,2425,2125,19,-0.38,0.35,0.5,0,,,684,38,570000,0.0012,No,560953,561637,Yes,-0.0303,0.2044,2495.96,2500.23,10.43,10.05
15/9/2017 15:30,18/9/2017 16:00,SPXW,Put,18/9/2017 0:00,3,2460,2150,18,-0.18,0.15,0.3,0,,,288,36,558000,0.000516129,No,561637,561925,Yes,-0.0307,0.0915,2498.39,2503.87,10.14,10.15
18/9/2017 15:30,20/9/2017 16:00,SPXW,Put,20/9/2017 0:00,2,2460,2150,18,-0.23,0.2,0.35,0,,,378,36,558000,0.000677419,No,561925,562303,Yes,-0.0321,0.1273,2503.38,2508.24,10.17,9.72
20/9/2017 15:30,22/9/2017 16:00,SPXW,Put,22/9/2017 0:00,2,2450,2150,19,-0.28,0.25,0.4,0,,,494,38,570000,0.000866667,No,562303,562797,Yes,-0.0305,0.1573,2503.95,2502.22,9.96,9.56
22/9/2017 15:30,25/9/2017 16:00,SPXW,Put,25/9/2017 0:00,3,2455,2150,18,-0.21,0.2,0.3,0,,,342,36,549000,0.000622951,No,562797,563139,Yes,-0.0292,0.1068,2500.53,2496.66,9.72,10.32
25/9/2017 15:30,27/9/2017 16:00,SPXW,Put,27/9/2017 0:00,2,2435,2130,18,-0.28,0.25,0.4,0,,,468,36,549000,0.000852459,No,563139,563607,Yes,-0.0283,0.1715,2495.18,2507.04,10.55,9.82
27/9/2017 15:30,29/9/2017 16:00,SPXW,Put,29/9/2017 0:00,2,2450,2150,19,-0.31,0.3,0.4,0,,,551,38,570000,0.000966667,No,563607,564158,Yes,-0.0295,0.1747,2511.03,2519.36,9.77,9.44
29/9/2017 15:30,2/10/2017 16:00,SPXW,Put,2/10/2017 0:00,3,2475,2175,19,-0.21,0.2,0.3,0,,,361,38,570000,0.000633333,No,564158,564519,Yes,-0.0312,0.0981,2516.64,2529.12,9.65,9.45
2/10/2017 15:30,4/10/2017 16:00,SPXW,Put,4/10/2017 0:00,2,2480,2180,19,-0.26,0.25,0.35,0,,,456,38,570000,0.0008,No,564519,564975,Yes,-0.032,0.1372,2527.58,2537.74,9.51,9.71
4/10/2017 15:30,6/10/2017 16:00,SPXW,Put,6/10/2017 0:00,2,2490,2190,19,-0.21,0.2,0.3,0,,,361,38,570000,0.000633333,No,564975,565336,Yes,-0.0284,0.1322,2537.81,2549.33,9.63,9.48
6/10/2017 15:30,9/10/2017 16:00,SPXW,Put,9/10/2017 0:00,3,2510,2210,19,-0.16,0.15,0.25,0,,,266,38,570000,0.000466667,No,565336,565602,Yes,-0.0293,0.0853,2547.1,2544.73,9.57,10.4
9/10/2017 15:30,11/10/2017 16:00,SPXW,Put,11/10/2017 0:00,2,2495,2190,19,-0.23,0.2,0.35,0,,,399,38,579500,0.000688525,No,565602,566001,Yes,-0.0294,0.1385,2544.02,2555.24,10.31,9.73
11/10/2017 15:30,13/10/2017 16:00,SPXW,Put,13/10/2017 0:00,2,2505,2205,19,-0.23,0.2,0.35,0,,,399,38,570000,0.0007,No,566001,566400,Yes,-0.0295,0.1374,2553.84,2553.17,9.82,9.64
13/10/2017 15:30,16/10/2017 16:00,SPXW,Put,16/10/2017 0:00,3,2510,2210,19,-0.26,0.25,0.35,0,,,456,38,570000,0.0008,No,566400,566856,Yes,-0.0328,0.1078,2555.65,2557.64,9.51,9.93
16/10/2017 15:30,18/10/2017 16:00,SPXW,Put,18/10/2017 0:00,2,2495,2200,19,-0.28,0.25,0.4,0,,,494,38,560500,0.000881356,No,566856,567350,Yes,-0.0279,0.1704,2556.24,2561.26,9.88,10.1
18/10/2017 15:30,20/10/2017 16:00,SPXW,Put,20/10/2017 0:00,2,2505,2205,19,-0.28,0.25,0.4,0,,,494,38,570000,0.000866667,No,567350,567844,Yes,-0.0289,0.1636,2563.44,2575.21,9.96,9.89
20/10/2017 15:30,23/10/2017 16:00,SPXW,Put,23/10/2017 0:00,3,2525,2225,19,-0.21,0.2,0.3,0,,,361,38,570000,0.000633333,No,567844,568205,Yes,-0.028,0.1086,2572.88,2564.98,9.89,10.88
23/10/2017 15:30,25/10/2017 16:00,SPXW,Put,25/10/2017 0:00,2,2505,2200,19,-0.33,0.3,0.45,0,,,589,38,579500,0.001016393,No,568205,568794,Yes,-0.0303,0.1766,2567.34,2557.15,10.67,11.62
25/10/2017 15:30,27/10/2017 16:00,SPXW,Put,27/10/2017 0:00,2,2490,2190,19,-0.31,0.25,0.45,0,,,551,38,570000,0.000966667,No,568794,569345,Yes,-0.028,0.1937,2559.22,2581.07,11.75,9.81
27/10/2017 15:30,30/10/2017 16:00,SPXW,Put,30/10/2017 0:00,3,2525,2225,19,-0.28,0.25,0.4,0,,,494,38,570000,0.000866667,No,569345,569839,Yes,-0.0298,0.1285,2581.25,2572.83,9.83,10.42
30/10/2017 15:30,31/10/2017 16:00,SPXW,Put,31/10/2017 0:00,1,2530,2230,19,-0.23,0.2,0.35,0,,,399,38,570000,0.0007,No,569839,570238,Yes,-0.0335,0.1651,2571.17,2575.26,10.61,10.11
31/10/2017 15:30,1/11/2017 16:00,SPXW,Put,1/11/2017 0:00,1,2540,2240,19,-0.18,0.15,0.3,0,,,304,38,570000,0.000533333,No,570238,570542,Yes,-0.0315,0.1472,2577.42,2579.36,9.99,10.15
1/11/2017 15:30,3/11/2017 16:00,SPXW,Put,3/11/2017 0:00,2,2515,2215,19,-0.33,0.3,0.45,0,,,589,38,570000,0.001033333,No,570542,571131,Yes,-0.0294,0.1819,2580.49,2587.84,9.91,9.03
3/11/2017 15:30,6/11/2017 16:00,SPXW,Put,6/11/2017 0:00,3,2540,2240,19,-0.21,0.2,0.3,0,,,361,38,570000,0.000633333,No,571131,571492,Yes,-0.0288,0.1049,2586.74,2591.13,9.15,9.43
6/11/2017 15:30,8/11/2017 16:00,SPXW,Put,8/11/2017 0:00,2,2545,2250,19,-0.23,0.2,0.35,0,,,399,38,560500,0.000711864,No,571492,571891,Yes,-0.03,0.1329,2592.9,2594.38,9.42,9.68
8/11/2017 15:30,10/11/2017 16:00,SPXW,Put,10/11/2017 0:00,2,2540,2240,19,-0.28,0.25,0.4,0,,,494,38,570000,0.000866667,No,571891,572385,Yes,-0.0312,0.1482,2593.86,2582.3,9.57,11.16
10/11/2017 15:30,13/11/2017 16:00,SPXW,Put,13/11/2017 0:00,3,2525,2225,19,-0.28,0.25,0.4,0,,,494,38,570000,0.000866667,No,572385,572879,Yes,-0.029,0.132,2583.26,2584.84,10.9,11.35
13/11/2017 15:30,15/11/2017 16:00,SPXW,Put,15/11/2017 0:00,2,2515,2210,19,-0.38,0.35,0.5,0,,,684,38,579500,0.001180328,No,572879,573563,Yes,-0.0301,0.1982,2586.45,2564.62,11.05,13.23
15/11/2017 15:30,17/11/2017 16:00,SPXW,Put,17/11/2017 0:00,2,2485,2185,19,-0.48,0.45,0.6,0,,,874,38,570000,0.001533333,No,573563,574437,Yes,-0.0316,0.2311,2566.43,2578.85,12.98,11.48
17/11/2017 15:30,20/11/2017 16:00,SPXW,Put,20/11/2017 0:00,3,2535,2230,19,-0.21,0.2,0.3,0,,,361,38,579500,0.000622951,No,574437,574798,Yes,-0.0296,0.102,2579.96,2582.14,11.55,10.71
20/11/2017 15:30,22/11/2017 16:00,SPXW,Put,22/11/2017 0:00,2,2535,2230,19,-0.23,0.2,0.35,0,,,399,38,579500,0.000688525,No,574798,575197,Yes,-0.0303,0.1318,2581.93,2597.08,10.71,9.75
22/11/2017 15:30,24/11/2017 16:00,SPXW,Put,24/11/2017 0:00,2,2560,2260,19,-0.16,0.15,0.25,0,,,266,38,570000,0.000466667,No,575197,575463,Yes,-0.0286,0.1048,2598.57,2602.42,9.72,9.67
24/11/2017 15:30,27/11/2017 16:00,SPXW,Put,27/11/2017 0:00,3,2565,2260,19,-0.16,0.1,0.3,0,,,266,38,579500,0.000459016,No,575463,575729,Yes,-0.0292,0.0838,2602.42,2601.42,9.67,9.89
27/11/2017 15:30,29/11/2017 16:00,SPXW,Put,29/11/2017 0:00,2,2555,2250,19,-0.23,0.2,0.35,0,,,399,38,579500,0.000688525,No,575729,576128,Yes,-0.0303,0.1309,2602.26,2626.07,9.82,10.65
29/11/2017 15:30,30/11/2017 16:00,SPXW,Put,30/11/2017 0:00,1,2575,2275,19,-0.21,0.2,0.3,0,,,361,38,570000,0.000633333,No,576128,576489,Yes,-0.0276,0.1849,2624.54,2647.58,10.59,11.21
30/11/2017 15:30,1/12/2017 16:00,SPXW,Put,1/12/2017 0:00,1,2590,2290,19,-0.24,0.15,0.4,0,,,418,38,570000,0.000733333,No,576489,576907,Yes,-0.0282,0.2116,2645.65,2642.22,11,11.3
1/12/2017 15:30,4/12/2017 16:00,SPXW,Put,4/12/2017 0:00,3,2540,2240,19,-0.56,0.5,0.7,0,,,1026,38,570000,0.0018,No,576907,577933,Yes,-0.0308,0.2239,2638.14,2639.44,12,11.8
4/12/2017 15:30,6/12/2017 16:00,SPXW,Put,6/12/2017 0:00,2,2580,2280,19,-0.31,0.25,0.45,0,,,551,38,570000,0.000966667,No,577933,578484,Yes,-0.0279,0.1762,2645.53,2629.27,11.04,11
6/12/2017 15:30,8/12/2017 16:00,SPXW,Put,8/12/2017 0:00,2,2575,2275,19,-0.28,0.25,0.4,0,,,494,38,570000,0.000866667,No,578484,578978,Yes,-0.0297,0.1544,2631.59,2651.5,10.99,9.58
8/12/2017 15:30,11/12/2017 16:00,SPXW,Put,11/12/2017 0:00,3,2615,2310,19,-0.18,0.15,0.3,0,,,304,38,579500,0.00052459,No,578978,579282,Yes,-0.0336,0.0779,2648.83,2659.99,9.74,9.31
11/12/2017 15:30,13/12/2017 16:00,SPXW,Put,13/12/2017 0:00,2,2610,2310,19,-0.23,0.2,0.35,0,,,399,38,570000,0.0007,No,579282,579681,Yes,-0.0306,0.1267,2656.13,2662.85,9.55,10.14
13/12/2017 15:30,15/12/2017 16:00,SPXW,Put,15/12/2017 0:00,2,2615,2315,19,-0.23,0.2,0.35,0,,,399,38,570000,0.0007,No,579681,580080,Yes,-0.0281,0.1388,2666.9,2675.81,9.92,9.53
15/12/2017 15:30,18/12/2017 16:00,SPXW,Put,18/12/2017 0:00,3,2630,2330,19,-0.23,0.2,0.35,0,,,399,38,570000,0.0007,No,580080,580479,Yes,-0.0294,0.1077,2678.85,2690.16,9.49,9.55
18/12/2017 15:30,20/12/2017 16:00,SPXW,Put,20/12/2017 0:00,2,2645,2345,19,-0.18,0.15,0.3,0,,,304,38,570000,0.000533333,No,580479,580783,Yes,-0.027,0.1204,2690.86,2679.25,9.4,9.67
20/12/2017 15:30,22/12/2017 16:00,SPXW,Put,22/12/2017 0:00,2,2630,2330,19,-0.23,0.2,0.35,0,,,399,38,570000,0.0007,No,580783,581182,Yes,-0.0284,0.1367,2680.6,2683.34,9.79,9.81
22/12/2017 15:30,26/12/2017 16:00,SPXW,Put,26/12/2017 0:00,4,2645,2340,19,-0.18,0.15,0.3,0,,,304,38,579500,0.00052459,No,581182,581486,Yes,-0.0308,0.0737,2682.87,2680.5,10.09,10.2
26/12/2017 15:30,27/12/2017 16:00,SPXW,Put,27/12/2017 0:00,1,2650,2350,19,-0.11,0.1,0.2,0,,,171,38,570000,0.0003,No,581486,581657,Yes,-0.029,0.1094,2678.46,2682.62,10.27,10.59
27/12/2017 15:30,29/12/2017 16:00,SPXW,Put,29/12/2017 0:00,2,2600,2300,19,-0.48,0.45,0.6,0,,,874,38,570000,0.001533333,No,581657,582531,Yes,-0.0313,0.2239,2679.58,2673.61,10.74,10.52
2/1/2018 9:31,3/1/2018 16:00,SPXW,Put,3/1/2018 0:00,1,2625,2325,19,-0.28,0.25,0.4,0,,,494,38,570000,0.000866667,No,582531,583025,Yes,-0.0282,0.2013,2685.58,2713.06,10.7,9.05
3/1/2018 15:30,5/1/2018 16:00,SPXW,Put,5/1/2018 0:00,2,2665,2365,19,-0.23,0.2,0.35,0,,,399,38,570000,0.0007,No,583025,583424,Yes,-0.0306,0.124,2711.42,2743.15,8.96,9.24
5/1/2018 15:30,8/1/2018 16:00,SPXW,Put,8/1/2018 0:00,3,2700,2400,19,-0.13,0.1,0.25,0,,,209,38,570000,0.000366667,No,583424,583633,Yes,-0.0261,0.0802,2738.62,2747.71,9.32,9.41
8/1/2018 15:30,10/1/2018 16:00,SPXW,Put,10/1/2018 0:00,2,2705,2405,19,-0.18,0.15,0.3,0,,,304,38,570000,0.000533333,No,583633,583937,Yes,-0.0297,0.1055,2745.69,2748.23,9.38,9.92
10/1/2018 15:30,12/1/2018 16:00,SPXW,Put,12/1/2018 0:00,2,2700,2400,19,-0.23,0.2,0.35,0,,,399,38,570000,0.0007,No,583937,584336,Yes,-0.031,0.1206,2744.92,2786.24,9.91,10.11
12/1/2018 15:30,16/1/2018 16:00,SPXW,Put,16/1/2018 0:00,4,2730,2430,19,-0.28,0.25,0.4,0,,,494,38,570000,0.000866667,No,584336,584830,Yes,-0.0309,0.0989,2782.95,2776.42,10.2,11.78
16/1/2018 15:30,17/1/2018 16:00,SPXW,Put,17/1/2018 0:00,1,2725,2425,19,-0.28,0.25,0.4,0,,,494,38,570000,0.000866667,No,584830,585324,Yes,-0.0293,0.2072,2781.81,2802.56,11.44,11.77
17/1/2018 15:30,19/1/2018 16:00,SPXW,Put,19/1/2018 0:00,2,2725,2425,20,-0.39,0.3,0.55,0,,,740,40,600000,0.001233333,No,585324,586064,Yes,-0.029,0.2013,2802.87,2810.3,11.46,11.24
19/1/2018 15:30,22/1/2018 16:00,SPXW,Put,22/1/2018 0:00,3,2755,2455,20,-0.26,0.2,0.4,0,,,480,40,600000,0.0008,No,586064,586544,Yes,-0.0302,0.1159,2809.13,2832.97,11.43,11.06
22/1/2018 15:30,24/1/2018 16:00,SPXW,Put,24/1/2018 0:00,2,2775,2475,20,-0.28,0.25,0.4,0,,,520,40,600000,0.000866667,No,586544,587064,Yes,-0.032,0.132,2825.38,2837.54,11.01,11.44
24/1/2018 15:30,26/1/2018 16:00,SPXW,Put,26/1/2018 0:00,2,2775,2475,20,-0.36,0.3,0.5,0,,,680,40,600000,0.001133333,No,587064,587744,Yes,-0.0308,0.1662,2839.46,2872.87,11.44,11.22
26/1/2018 15:30,29/1/2018 16:00,SPXW,Put,29/1/2018 0:00,3,2820,2520,20,-0.23,0.2,0.35,0,,,420,40,600000,0.0007,No,587744,588164,Yes,-0.0306,0.0961,2865.8,2853.53,11.26,13.62
29/1/2018 15:30,31/1/2018 16:00,SPXW,Put,31/1/2018 0:00,2,2785,2485,20,-0.43,0.4,0.55,0,,,820,40,600000,0.001366667,No,588164,588984,Yes,-0.0318,0.1874,2857.84,2823.81,13.18,13.75
31/1/2018 15:30,2/2/2018 16:00,SPXW,Put,2/2/2018 0:00,2,2735,2435,20,-0.46,0.4,0.6,0,,,880,40,600000,0.001466667,No,588984,589864,Yes,-0.0304,0.2202,2820.34,2762.13,13.86,17.45
2/2/2018 15:30,5/2/2018 16:00,SPXW,Put,5/2/2018 0:00,3,2620,2325,20,-0.83,0.7,1.05,0,,,1620,40,590000,0.002745763,No,589864,591484,Yes,-0.0297,0.3242,2770.01,2648.94,16.96,32.98
5/2/2018 15:30,7/2/2018 16:00,SPXW,Put,7/2/2018 0:00,2,2250,1950,20,-2.81,1.4,4.3,0,,,5580,40,600000,0.0093,No,591484,597064,Yes,-0.0323,1.3437,2696.92,2681.66,30.86,25.94
7/2/2018 15:30,9/2/2018 16:00,SPXW,Put,9/2/2018 0:00,2,2475,2175,20,-1.19,1,1.45,0,,,2340,40,600000,0.0039,No,597064,599404,Yes,-0.0305,0.6462,2707.04,2619.55,23.54,29.62
9/2/2018 15:30,12/2/2018 16:00,SPXW,Put,12/2/2018 0:00,3,2290,2000,21,-1.58,1.4,1.85,0,,,3276,42,609000,0.00537931,No,599404,602680,Yes,-0.0306,0.7444,2594.77,2656,32.62,25.9
12/2/2018 15:30,14/2/2018 16:00,SPXW,Put,14/2/2018 0:00,2,2540,2240,20,-0.71,0.55,0.95,0,,,1380,40,600000,0.0023,No,602680,604060,Yes,-0.0303,0.349,2667.05,2698.63,24.68,19.16
14/2/2018 15:30,16/2/2018 16:00,SPXW,Put,16/2/2018 0:00,2,2570,2270,20,-0.69,0.6,0.85,0,,,1340,40,600000,0.002233333,No,604060,605400,Yes,-0.0288,0.3427,2697.44,2732.22,19.5,19.52
16/2/2018 15:30,20/2/2018 16:00,SPXW,Put,20/2/2018 0:00,4,2625,2325,20,-0.64,0.55,0.8,0,,,1240,40,600000,0.002066667,No,605400,606640,Yes,-0.0297,0.2176,2740.17,2716.26,19.63,20.54
20/2/2018 15:30,21/2/2018 16:00,SPXW,Put,21/2/2018 0:00,1,2635,2335,20,-0.38,0.35,0.5,0,,,720,40,600000,0.0012,No,606640,607360,Yes,-0.0282,0.2855,2712.56,2701.33,20.73,19.9
21/2/2018 15:30,23/2/2018 16:00,SPXW,Put,23/2/2018 0:00,2,2635,2335,20,-0.54,0.45,0.7,0,,,1040,40,600000,0.001733333,No,607360,608400,Yes,-0.0322,0.2417,2723.92,2747.3,18.41,16.48
23/2/2018 15:30,26/2/2018 16:00,SPXW,Put,26/2/2018 0:00,3,2675,2375,20,-0.33,0.3,0.45,0,,,620,40,600000,0.001033333,No,608400,609020,Yes,-0.0288,0.1434,2742.34,2779.6,16.65,16
26/2/2018 15:30,28/2/2018 16:00,SPXW,Put,28/2/2018 0:00,2,2700,2400,20,-0.43,0.4,0.55,0,,,820,40,600000,0.001366667,No,609020,609840,Yes,-0.0299,0.207,2779.4,2713.83,16.24,20.4
28/2/2018 15:30,2/3/2018 16:00,SPXW,Put,2/3/2018 0:00,2,2610,2310,20,-0.66,0.55,0.85,0,,,1280,40,600000,0.002133333,No,609840,611120,Yes,-0.0297,0.3269,2732.21,2691.25,19.62,19.51
2/3/2018 15:30,5/3/2018 16:00,SPXW,Put,5/3/2018 0:00,3,2580,2280,20,-0.56,0.45,0.75,0,,,1080,40,600000,0.0018,No,611120,612200,Yes,-0.0314,0.2241,2679.66,2720.94,20.89,18.45
5/3/2018 15:30,7/3/2018 16:00,SPXW,Put,7/3/2018 0:00,2,2625,2325,20,-0.54,0.45,0.7,0,,,1040,40,600000,0.001733333,No,612200,613240,Yes,-0.0304,0.2583,2721.42,2726.8,18.36,17.76
7/3/2018 15:30,9/3/2018 16:00,SPXW,Put,9/3/2018 0:00,2,2630,2330,20,-0.49,0.4,0.65,0,,,940,40,600000,0.001566667,No,613240,614180,Yes,-0.0291,0.2498,2724.43,2786.57,17.83,14.58
9/3/2018 15:30,12/3/2018 16:00,SPXW,Put,12/3/2018 0:00,3,2720,2420,20,-0.36,0.3,0.5,0,,,680,40,600000,0.001133333,No,614180,614860,Yes,-0.0324,0.1315,2780.06,2783.02,14.86,15.78
12/3/2018 15:30,14/3/2018 16:00,SPXW,Put,14/3/2018 0:00,2,2705,2405,20,-0.43,0.4,0.55,0,,,820,40,600000,0.001366667,No,614860,615680,Yes,-0.0296,0.2085,2785.89,2749.48,15.61,17.19
14/3/2018 15:30,16/3/2018 16:00,SPXW,Put,16/3/2018 0:00,2,2600,2300,21,-0.86,0.75,1.05,0,,,1764,42,630000,0.0028,No,615680,617444,Yes,-0.0306,0.3955,2746.89,2752.01,17.37,15.76
16/3/2018 15:30,19/3/2018 16:00,SPXW,Put,19/3/2018 0:00,3,2690,2390,21,-0.31,0.25,0.45,0,,,609,42,630000,0.000966667,No,617444,618053,Yes,-0.0293,0.1399,2755.27,2712.92,15.64,19.58
19/3/2018 15:30,21/3/2018 16:00,SPXW,Put,21/3/2018 0:00,2,2500,2200,21,-1.21,1.15,1.35,0,,,2499,42,630000,0.003966667,No,618053,620552,Yes,-0.0308,0.5687,2704.69,2711.93,20.11,17.96
21/3/2018 15:30,23/3/2018 16:00,SPXW,Put,23/3/2018 0:00,2,2590,2290,21,-0.74,0.65,0.9,1.74,,,-2142,42,630000,-0.0034,Yes,620552,618410,Yes,-0.0308,0.3562,2720.96,2588.26,17.31,25.65
23/3/2018 15:30,26/3/2018 16:00,SPXW,Put,26/3/2018 0:00,3,2425,2125,21,-0.96,0.75,1.25,0,,,1974,42,630000,0.003133333,No,618410,620384,Yes,-0.0303,0.4232,2605.73,2658.55,24.87,20.91
26/3/2018 15:30,28/3/2018 16:00,SPXW,Put,28/3/2018 0:00,2,2525,2225,21,-0.71,0.65,0.85,0,,,1449,42,630000,0.0023,No,620384,621833,Yes,-0.0307,0.3556,2652.57,2605,21.13,22.71
28/3/2018 15:30,29/3/2018 16:00,SPXW,Put,29/3/2018 0:00,1,2505,2200,20,-0.56,0.4,0.8,0,,,1080,40,610000,0.001770492,No,621833,622913,Yes,-0.0307,0.4173,2611.06,2640.87,23.65,19.77
29/3/2018 15:30,2/4/2018 16:00,SPXW,Put,2/4/2018 0:00,4,2550,2250,21,-0.51,0.35,0.75,0,,,1029,42,630000,0.001633333,No,622913,623942,Yes,-0.0297,0.1937,2649.05,2581.88,20.08,23.33
2/4/2018 15:30,4/4/2018 16:00,SPXW,Put,4/4/2018 0:00,2,2415,2125,22,-0.78,0.7,0.95,0,,,1672,44,638000,0.00262069,No,623942,625614,Yes,-0.0305,0.4356,2566.28,2644.69,24.67,20.2
4/4/2018 15:30,6/4/2018 16:00,SPXW,Put,6/4/2018 0:00,2,2515,2215,21,-0.71,0.6,0.9,0,,,1449,42,630000,0.0023,No,625614,627063,Yes,-0.0296,0.3504,2641.23,2604.47,20.34,21.45
6/4/2018 15:30,9/4/2018 16:00,SPXW,Put,9/4/2018 0:00,3,2455,2150,21,-0.78,0.65,1,0,,,1596,42,640500,0.002491803,No,627063,628659,Yes,-0.0301,0.323,2594.9,2613.16,22.28,21.9
9/4/2018 15:30,11/4/2018 16:00,SPXW,Put,11/4/2018 0:00,2,2515,2220,21,-0.69,0.6,0.85,0,,,1407,42,619500,0.002271186,No,628659,630066,Yes,-0.0304,0.3305,2633.3,2642.19,21.14,20.19
11/4/2018 15:30,13/4/2018 16:00,SPXW,Put,13/4/2018 0:00,2,2515,2215,21,-0.74,0.65,0.9,0,,,1512,42,630000,0.0024,No,630066,631578,Yes,-0.0301,0.3548,2642.62,2656.3,20.41,17.48
13/4/2018 15:30,16/4/2018 16:00,SPXW,Put,16/4/2018 0:00,3,2565,2260,21,-0.41,0.35,0.55,0,,,819,42,640500,0.001278689,No,631578,632397,Yes,-0.0277,0.1837,2648.52,2677.84,18.22,16.53
16/4/2018 15:30,18/4/2018 16:00,SPXW,Put,18/4/2018 0:00,2,2580,2280,21,-0.56,0.5,0.7,0,,,1134,42,630000,0.0018,No,632397,633531,Yes,-0.0296,0.2702,2679.52,2708.64,16.78,15.53
18/4/2018 15:30,20/4/2018 16:00,SPXW,Put,20/4/2018 0:00,2,2610,2310,21,-0.56,0.5,0.7,0,,,1134,42,630000,0.0018,No,633531,634665,Yes,-0.0297,0.277,2713.25,2670.14,15.5,16.94
20/4/2018 15:30,23/4/2018 16:00,SPXW,Put,23/4/2018 0:00,3,2590,2290,21,-0.38,0.3,0.55,0,,,756,42,630000,0.0012,No,634665,635421,Yes,-0.029,0.1644,2664.27,2670.29,17.28,16.5
23/4/2018 15:30,25/4/2018 16:00,SPXW,Put,25/4/2018 0:00,2,2585,2280,21,-0.46,0.4,0.6,0,,,924,42,640500,0.001442623,No,635421,636345,Yes,-0.0301,0.224,2667.14,2639.4,16.66,18.04
25/4/2018 15:30,27/4/2018 16:00,SPXW,Put,27/4/2018 0:00,2,2540,2240,21,-0.59,0.5,0.75,0,,,1197,42,630000,0.0019,No,636345,637542,Yes,-0.031,0.2812,2640.87,2669.91,18.03,15.47
27/4/2018 15:30,30/4/2018 16:00,SPXW,Put,30/4/2018 0:00,3,2600,2300,21,-0.36,0.3,0.5,0,,,714,42,630000,0.001133333,No,637542,638256,Yes,-0.0295,0.1522,2668.64,2648.05,15.68,16.08
30/4/2018 15:30,2/5/2018 16:00,SPXW,Put,2/5/2018 0:00,2,2565,2260,21,-0.49,0.4,0.65,0,,,987,42,640500,0.001540984,No,638256,639243,Yes,-0.0305,0.243,2653.32,2635.67,16.04,15.67
2/5/2018 15:30,4/5/2018 16:00,SPXW,Put,4/5/2018 0:00,2,2565,2265,21,-0.44,0.35,0.6,0,,,882,42,630000,0.0014,No,639243,640125,Yes,-0.0318,0.2129,2641.88,2663.42,15.28,14.84
4/5/2018 15:30,7/5/2018 16:00,SPXW,Put,7/5/2018 0:00,3,2595,2290,21,-0.33,0.3,0.45,0,,,651,42,640500,0.001016393,No,640125,640776,Yes,-0.027,0.1585,2667.57,2672.63,14.93,14.73
7/5/2018 15:30,9/5/2018 16:00,SPXW,Put,9/5/2018 0:00,2,2595,2290,21,-0.43,0.4,0.55,0,,,861,42,640500,0.001344262,No,640776,641637,Yes,-0.0315,0.2027,2668.99,2697.79,14.97,13.45
9/5/2018 15:30,11/5/2018 16:00,SPXW,Put,11/5/2018 0:00,2,2630,2330,21,-0.38,0.35,0.5,0,,,756,42,630000,0.0012,No,641637,642393,Yes,-0.0321,0.1772,2696.02,2727.72,13.64,12.78
11/5/2018 15:30,14/5/2018 16:00,SPXW,Put,14/5/2018 0:00,3,2670,2370,21,-0.23,0.2,0.35,0,,,441,42,630000,0.0007,No,642393,642834,Yes,-0.0267,0.1179,2726.18,2730.13,12.87,12.91
14/5/2018 15:30,16/5/2018 16:00,SPXW,Put,16/5/2018 0:00,2,2665,2360,21,-0.38,0.35,0.5,0,,,756,42,640500,0.001180328,No,642834,643590,Yes,-0.0317,0.1771,2731.72,2722.46,12.94,13.48
16/5/2018 15:30,18/5/2018 16:00,SPXW,Put,18/5/2018 0:00,2,2650,2350,21,-0.41,0.4,0.5,0,,,819,42,630000,0.0013,No,643590,644409,Yes,-0.031,0.1926,2722.19,2712.97,13.44,13.36
18/5/2018 15:30,21/5/2018 16:00,SPXW,Put,21/5/2018 0:00,3,2670,2370,21,-0.21,0.2,0.3,0,,,399,42,630000,0.000633333,No,644409,644808,Yes,-0.0299,0.0957,2714.21,2733.01,13.39,13.2
21/5/2018 15:30,23/5/2018 16:00,SPXW,Put,23/5/2018 0:00,2,2680,2380,21,-0.28,0.25,0.4,0,,,546,42,630000,0.000866667,No,644808,645354,Yes,-0.0324,0.1345,2729.95,2733.29,13.24,12.56
23/5/2018 15:30,25/5/2018 16:00,SPXW,Put,25/5/2018 0:00,2,2675,2375,22,-0.23,0.2,0.35,0,,,462,44,660000,0.0007,No,645354,645816,Yes,-0.0274,0.1397,2729.12,2721.33,12.88,13.11
25/5/2018 15:30,29/5/2018 16:00,SPXW,Put,29/5/2018 0:00,4,2670,2370,22,-0.28,0.25,0.4,0,,,572,44,660000,0.000866667,No,645816,646388,Yes,-0.032,0.0974,2721.13,2689.86,13.14,17.26
29/5/2018 15:30,30/5/2018 16:00,SPXW,Put,30/5/2018 0:00,1,2595,2300,22,-0.41,0.4,0.5,0,,,858,44,649000,0.001322034,No,646388,647246,Yes,-0.0296,0.3192,2680,2724.01,18.48,14.88
30/5/2018 15:30,31/5/2018 16:00,SPXW,Put,31/5/2018 0:00,1,2670,2370,22,-0.23,0.2,0.35,0,,,462,44,660000,0.0007,No,647246,647708,Yes,-0.0274,0.1962,2724.28,2705.27,14.96,15.53
31/5/2018 15:30,1/6/2018 16:00,SPXW,Put,1/6/2018 0:00,1,2650,2350,22,-0.26,0.2,0.4,0,,,528,44,660000,0.0008,No,647708,648236,Yes,-0.0268,0.2186,2710.28,2734.62,15.41,13.53
1/6/2018 15:30,4/6/2018 16:00,SPXW,Put,4/6/2018 0:00,3,2680,2380,22,-0.18,0.15,0.3,0,,,352,44,660000,0.000533333,No,648236,648588,Yes,-0.0252,0.1048,2730.51,2746.87,13.66,12.74
4/6/2018 15:30,6/6/2018 16:00,SPXW,Put,6/6/2018 0:00,2,2690,2390,22,-0.28,0.25,0.4,0,,,572,44,660000,0.000866667,No,648588,649160,Yes,-0.0295,0.149,2746.92,2772.35,12.75,11.66
6/6/2018 15:30,8/6/2018 16:00,SPXW,Put,8/6/2018 0:00,2,2705,2405,22,-0.31,0.3,0.4,0,,,638,44,660000,0.000966667,No,649160,649798,Yes,-0.029,0.1614,2767.48,2779.03,11.87,12.15
8/6/2018 15:30,11/6/2018 16:00,SPXW,Put,11/6/2018 0:00,3,2725,2425,22,-0.28,0.25,0.4,0,,,572,44,660000,0.000866667,No,649798,650370,Yes,-0.0316,0.1115,2776.65,2782,12.19,12.35
11/6/2018 15:30,13/6/2018 16:00,SPXW,Put,13/6/2018 0:00,2,2710,2410,22,-0.51,0.5,0.6,0,,,1078,44,660000,0.001633333,No,650370,651448,Yes,-0.0332,0.2102,2788.81,2775.63,12.15,12.86
13/6/2018 15:30,15/6/2018 16:00,SPXW,Put,15/6/2018 0:00,2,2700,2400,22,-0.46,0.4,0.6,0,,,968,44,660000,0.001466667,No,651448,652416,Yes,-0.0312,0.2165,2782.79,2779.66,12.53,11.97
15/6/2018 15:30,18/6/2018 16:00,SPXW,Put,18/6/2018 0:00,3,2715,2415,22,-0.33,0.3,0.45,0,,,682,44,660000,0.001033333,No,652416,653098,Yes,-0.0298,0.1363,2778.99,2773.75,12.05,12.39
18/6/2018 15:30,20/6/2018 16:00,SPXW,Put,20/6/2018 0:00,2,2705,2400,21,-0.33,0.3,0.45,0,,,651,42,640500,0.001016393,No,653098,653749,Yes,-0.0291,0.1714,2771.51,2767.32,12.53,12.82
20/6/2018 15:30,22/6/2018 16:00,SPXW,Put,22/6/2018 0:00,2,2705,2405,22,-0.38,0.35,0.5,0,,,792,44,660000,0.0012,No,653749,654541,Yes,-0.0317,0.1745,2770.75,2754.88,12.57,14.06
22/6/2018 15:30,25/6/2018 16:00,SPXW,Put,25/6/2018 0:00,3,2700,2400,22,-0.28,0.25,0.4,0,,,572,44,660000,0.000866667,No,654541,655113,Yes,-0.0281,0.1283,2760.49,2717.07,13.64,17.33
25/6/2018 15:30,27/6/2018 16:00,SPXW,Put,27/6/2018 0:00,2,2580,2275,21,-0.61,0.55,0.75,0,,,1239,42,640500,0.001934426,No,655113,656352,Yes,-0.029,0.3393,2705.97,2699.63,18.66,17.98
27/6/2018 15:30,29/6/2018 16:00,SPXW,Put,29/6/2018 0:00,2,2610,2310,22,-0.56,0.5,0.7,0,,,1188,44,660000,0.0018,No,656352,657540,Yes,-0.0316,0.2781,2712.13,2718.37,17.42,16.18
29/6/2018 15:30,2/7/2018 16:00,SPXW,Put,2/7/2018 0:00,3,2650,2350,22,-0.38,0.35,0.5,0,,,792,44,660000,0.0012,No,657540,658332,Yes,-0.0292,0.1771,2731.72,2726.71,15.78,15.54
2/7/2018 15:30,3/7/2018 16:00,SPXW,Put,3/7/2018 0:00,1,2675,2375,22,-0.26,0.25,0.35,0,,,528,44,660000,0.0008,No,658332,658860,Yes,-0.0332,0.1708,2719.98,2713.22,16.01,16.14
3/7/2018 15:30,6/7/2018 16:00,SPXW,Put,6/7/2018 0:00,3,2625,2325,22,-0.49,0.45,0.6,0,,,1034,44,660000,0.001566667,No,658860,659894,Yes,-0.031,0.1917,2713.22,2759.82,16.14,13.38
6/7/2018 15:30,9/7/2018 16:00,SPXW,Put,9/7/2018 0:00,3,2705,2400,22,-0.31,0.25,0.45,0,,,638,44,671000,0.00095082,No,659894,660532,Yes,-0.0307,0.1244,2763.65,2784.17,13.42,12.68
9/7/2018 15:30,11/7/2018 16:00,SPXW,Put,11/7/2018 0:00,2,2715,2410,22,-0.31,0.3,0.4,0,,,638,44,671000,0.00095082,No,660532,661170,Yes,-0.0275,0.1708,2781.73,2774.02,12.76,13.5
11/7/2018 15:30,13/7/2018 16:00,SPXW,Put,13/7/2018 0:00,2,2705,2405,22,-0.31,0.25,0.45,0,,,638,44,660000,0.000966667,No,661170,661808,Yes,-0.028,0.1785,2774.49,2801.31,13.57,12.23
13/7/2018 15:30,16/7/2018 16:00,SPXW,Put,16/7/2018 0:00,3,2750,2450,22,-0.28,0.25,0.4,0,,,572,44,660000,0.000866667,No,661808,662380,Yes,-0.032,0.1089,2800.95,2798.43,12.38,12.55
16/7/2018 15:30,18/7/2018 16:00,SPXW,Put,18/7/2018 0:00,2,2735,2430,22,-0.31,0.3,0.4,0,,,638,44,671000,0.00095082,No,662380,663018,Yes,-0.0291,0.1591,2796.76,2815.62,12.69,11.99
18/7/2018 15:30,20/7/2018 16:00,SPXW,Put,20/7/2018 0:00,2,2760,2460,22,-0.31,0.3,0.4,0,,,638,44,660000,0.000966667,No,663018,663656,Yes,-0.0314,0.1448,2815.82,2801.83,11.87,12.86
20/7/2018 15:30,23/7/2018 16:00,SPXW,Put,23/7/2018 0:00,3,2750,2450,22,-0.28,0.25,0.4,0,,,572,44,660000,0.000866667,No,663656,664228,Yes,-0.0319,0.1094,2801.18,2806.98,12.98,12.74
23/7/2018 15:30,25/7/2018 16:00,SPXW,Put,25/7/2018 0:00,2,2750,2450,22,-0.28,0.25,0.4,0,,,572,44,660000,0.000866667,No,664228,664800,Yes,-0.0294,0.1465,2807.16,2846.07,12.77,12.04
25/7/2018 15:30,27/7/2018 16:00,SPXW,Put,27/7/2018 0:00,2,2765,2465,22,-0.33,0.3,0.45,0,,,682,44,660000,0.001033333,No,664800,665482,Yes,-0.0286,0.1707,2831.84,2818.82,12.13,13.09
27/7/2018 15:30,30/7/2018 16:00,SPXW,Put,30/7/2018 0:00,3,2735,2430,22,-0.41,0.35,0.55,0,,,858,44,671000,0.001278689,No,665482,666340,Yes,-0.0295,0.1696,2815.95,2802.6,13.47,14.2
30/7/2018 15:30,31/7/2018 16:00,SPXW,Put,31/7/2018 0:00,1,2750,2450,22,-0.31,0.3,0.4,0,,,638,44,660000,0.000966667,No,666340,666978,Yes,-0.0332,0.1914,2801.78,2816.29,14.3,13.18
31/7/2018 15:30,1/8/2018 16:00,SPXW,Put,1/8/2018 0:00,1,2765,2465,22,-0.28,0.25,0.4,0,,,572,44,660000,0.000866667,No,666978,667550,Yes,-0.0311,0.1912,2817.71,2813.36,13.3,12.98
1/8/2018 15:30,3/8/2018 16:00,SPXW,Put,3/8/2018 0:00,2,2740,2440,22,-0.36,0.3,0.5,0,,,748,44,660000,0.001133333,No,667550,668298,Yes,-0.029,0.19,2814.68,2840.35,13.09,11.72
3/8/2018 15:30,6/8/2018 16:00,SPXW,Put,6/8/2018 0:00,3,2785,2480,22,-0.23,0.2,0.35,0,,,462,44,671000,0.000688525,No,668298,668760,Yes,-0.0278,0.1083,2838.23,2850.4,11.77,11.28
6/8/2018 15:30,8/8/2018 16:00,SPXW,Put,8/8/2018 0:00,2,2800,2500,22,-0.28,0.25,0.4,0,,,572,44,660000,0.000866667,No,668760,669332,Yes,-0.0324,0.1289,2850.15,2857.7,11.19,10.66
8/8/2018 15:30,10/8/2018 16:00,SPXW,Put,10/8/2018 0:00,2,2810,2510,22,-0.23,0.2,0.35,0,,,462,44,660000,0.0007,No,669332,669794,Yes,-0.0288,0.1259,2861.54,2833.28,10.54,13.23
10/8/2018 15:30,13/8/2018 16:00,SPXW,Put,13/8/2018 0:00,3,2750,2450,22,-0.43,0.4,0.55,0,,,902,44,660000,0.001366667,No,669794,670696,Yes,-0.0304,0.1791,2835.07,2821.93,13.12,14.86
13/8/2018 15:30,15/8/2018 16:00,SPXW,Put,15/8/2018 0:00,2,2715,2410,22,-0.61,0.55,0.75,0,,,1298,44,671000,0.001934426,No,670696,671994,Yes,-0.0299,0.2838,2825.24,2818.37,14.62,15.09
15/8/2018 15:30,17/8/2018 16:00,SPXW,Put,17/8/2018 0:00,2,2695,2395,22,-0.58,0.55,0.7,0,,,1232,44,660000,0.001866667,No,671994,673226,Yes,-0.0294,0.3108,2815.7,2850.13,15.55,12.66
17/8/2018 15:30,20/8/2018 16:00,SPXW,Put,20/8/2018 0:00,3,2790,2490,22,-0.26,0.2,0.4,0,,,528,44,660000,0.0008,No,673226,673754,Yes,-0.0279,0.125,2851.24,2857.05,12.53,12.48
20/8/2018 15:30,22/8/2018 16:00,SPXW,Put,22/8/2018 0:00,2,2785,2480,22,-0.36,0.3,0.5,0,,,748,44,671000,0.001114754,No,673754,674502,Yes,-0.0293,0.185,2858.45,2861.82,12.5,12.08
22/8/2018 15:30,24/8/2018 16:00,SPXW,Put,24/8/2018 0:00,2,2800,2500,22,-0.33,0.3,0.45,0,,,682,44,660000,0.001033333,No,674502,675184,Yes,-0.0299,0.1606,2863.32,2874.69,12.07,12.1
24/8/2018 15:30,27/8/2018 16:00,SPXW,Put,27/8/2018 0:00,3,2820,2520,23,-0.28,0.25,0.4,0,,,598,46,690000,0.000866667,No,675184,675782,Yes,-0.0307,0.1116,2874.09,2896.74,12.14,12.08
27/8/2018 15:30,29/8/2018 16:00,SPXW,Put,29/8/2018 0:00,2,2835,2530,22,-0.28,0.25,0.4,0,,,572,44,671000,0.000852459,No,675782,676354,Yes,-0.0281,0.1495,2895.92,2914.04,12.19,12.18
29/8/2018 15:30,31/8/2018 16:00,SPXW,Put,31/8/2018 0:00,2,2865,2565,23,-0.28,0.25,0.4,0,,,598,46,690000,0.000866667,No,676354,676952,Yes,-0.0323,0.1265,2915.37,2901.52,12.16,13
31/8/2018 15:30,4/9/2018 16:00,SPXW,Put,4/9/2018 0:00,4,2820,2520,23,-0.31,0.3,0.4,0,,,667,46,690000,0.000966667,No,676952,677619,Yes,-0.0304,0.1317,2894.06,2896.72,13.56,13.24
4/9/2018 15:30,5/9/2018 16:00,SPXW,Put,5/9/2018 0:00,1,2845,2545,23,-0.21,0.2,0.3,0,,,437,46,690000,0.000633333,No,677619,678056,Yes,-0.0271,0.1716,2895.35,2888.6,13.29,13.63
5/9/2018 15:30,7/9/2018 16:00,SPXW,Put,7/9/2018 0:00,2,2810,2510,23,-0.38,0.35,0.5,0,,,828,46,690000,0.0012,No,678056,678884,Yes,-0.0302,0.1965,2888.49,2871.68,13.55,14.88
7/9/2018 15:30,10/9/2018 16:00,SPXW,Put,10/9/2018 0:00,3,2810,2510,23,-0.36,0.3,0.5,0,,,782,46,690000,0.001133333,No,678884,679666,Yes,-0.0321,0.1364,2874.88,2877.13,14.71,14.2
10/9/2018 15:30,12/9/2018 16:00,SPXW,Put,12/9/2018 0:00,2,2805,2500,22,-0.36,0.3,0.5,0,,,748,44,671000,0.001114754,No,679666,680414,Yes,-0.0289,0.1869,2879.87,2888.92,14.14,13.09
12/9/2018 15:30,14/9/2018 16:00,SPXW,Put,14/9/2018 0:00,2,2820,2520,23,-0.36,0.3,0.5,0,,,782,46,690000,0.001133333,No,680414,681196,Yes,-0.0305,0.1753,2890.65,2904.98,12.97,12.09
14/9/2018 15:30,17/9/2018 16:00,SPXW,Put,17/9/2018 0:00,3,2845,2540,22,-0.31,0.3,0.4,0,,,638,44,671000,0.00095082,No,681196,681834,Yes,-0.0305,0.1192,2903.17,2888.8,12.17,13.54
17/9/2018 15:30,19/9/2018 16:00,SPXW,Put,19/9/2018 0:00,2,2785,2480,22,-0.61,0.55,0.75,0,,,1298,44,671000,0.001934426,No,681834,683132,Yes,-0.0311,0.2658,2889.1,2907.95,13.42,11.77
19/9/2018 15:30,21/9/2018 16:00,SPXW,Put,21/9/2018 0:00,2,2810,2510,23,-0.51,0.45,0.65,0,,,1127,46,690000,0.001633333,No,683132,684259,Yes,-0.0289,0.2457,2908.17,2929.67,11.87,11.57
21/9/2018 15:30,24/9/2018 16:00,SPXW,Put,24/9/2018 0:00,3,2870,2570,23,-0.33,0.3,0.45,0,,,713,46,690000,0.001033333,No,684259,684972,Yes,-0.0309,0.1239,2930.56,2919.37,11.52,12.28
24/9/2018 15:30,26/9/2018 16:00,SPXW,Put,26/9/2018 0:00,2,2850,2550,23,-0.36,0.35,0.45,0,,,782,46,690000,0.001133333,No,684972,685754,Yes,-0.0292,0.1723,2920.08,2905.97,12.3,13
26/9/2018 15:30,28/9/2018 16:00,SPXW,Put,28/9/2018 0:00,2,2840,2540,23,-0.43,0.4,0.55,0,,,943,46,690000,0.001366667,No,685754,686697,Yes,-0.0313,0.2055,2922.11,2913.98,11.93,12.4
28/9/2018 15:30,1/10/2018 16:00,SPXW,Put,1/10/2018 0:00,3,2835,2530,23,-0.41,0.35,0.55,0,,,897,46,701500,0.001278689,No,686697,687594,Yes,-0.0297,0.1625,2914.56,2924.59,12.42,12.08
1/10/2018 15:30,3/10/2018 16:00,SPXW,Put,3/10/2018 0:00,2,2850,2550,23,-0.38,0.35,0.5,0,,,828,46,690000,0.0012,No,687594,688422,Yes,-0.0296,0.1794,2922.45,2925.51,12.2,11.7
3/10/2018 15:30,5/10/2018 16:00,SPXW,Put,5/10/2018 0:00,2,2845,2545,23,-0.41,0.35,0.55,0,,,897,46,690000,0.0013,No,688422,689319,Yes,-0.03,0.1953,2923.74,2885.57,12.04,15.23
5/10/2018 15:30,8/10/2018 16:00,SPXW,Put,8/10/2018 0:00,3,2775,2475,23,-0.56,0.5,0.7,0,,,1242,46,690000,0.0018,No,689319,690561,Yes,-0.0289,0.2286,2886.29,2884.43,15.35,15.97
8/10/2018 15:30,10/10/2018 16:00,SPXW,Put,10/10/2018 0:00,2,2780,2480,23,-0.54,0.45,0.7,0,,,1196,46,690000,0.001733333,No,690561,691757,Yes,-0.0287,0.2608,2884.69,2785.68,15.96,22.54
10/10/2018 15:30,12/10/2018 16:00,SPXW,Put,12/10/2018 0:00,2,2620,2320,23,-0.88,0.75,1.1,0,,,1978,46,690000,0.002866667,No,691757,693735,Yes,-0.0302,0.5202,2816.05,2767.13,20.43,21.3
12/10/2018 15:30,15/10/2018 16:00,SPXW,Put,15/10/2018 0:00,3,2605,2300,23,-0.91,0.75,1.15,0,,,2047,46,701500,0.002918033,No,693735,695782,Yes,-0.03,0.346,2763.07,2750.79,22.32,21.06
15/10/2018 15:30,17/10/2018 16:00,SPXW,Put,17/10/2018 0:00,2,2620,2320,23,-0.81,0.75,0.95,0,,,1817,46,690000,0.002633333,No,695782,697599,Yes,-0.0308,0.3803,2762.4,2809.21,20.48,17.54
17/10/2018 15:30,19/10/2018 16:00,SPXW,Put,19/10/2018 0:00,2,2685,2385,23,-0.69,0.6,0.85,0,,,1541,46,690000,0.002233333,No,697599,699140,Yes,-0.0291,0.3258,2810.93,2767.78,17.58,19.81
19/10/2018 15:30,22/10/2018 16:00,SPXW,Put,22/10/2018 0:00,3,2655,2360,24,-0.71,0.6,0.9,0,,,1656,48,708000,0.002338983,No,699140,700796,Yes,-0.0309,0.2606,2774.88,2755.88,19.57,19.49
22/10/2018 15:30,24/10/2018 16:00,SPXW,Put,24/10/2018 0:00,2,2660,2360,23,-0.59,0.5,0.75,3.9,,,-7659,46,690000,-0.0111,Yes,700796,693137,Yes,-0.0306,0.2727,2762.52,2656.1,19.15,26.04
24/10/2018 15:30,26/10/2018 16:00,SPXW,Put,26/10/2018 0:00,2,2490,2190,23,-0.96,0.8,1.2,0,,,2162,46,690000,0.003133333,No,693137,695299,Yes,-0.0291,0.5167,2676.41,2658.69,24.09,25.2
26/10/2018 15:30,29/10/2018 16:00,SPXW,Put,29/10/2018 0:00,3,2410,2100,22,-1.46,1.35,1.65,0,,,3168,44,682000,0.004645161,No,695299,698467,Yes,-0.0293,0.5736,2657.51,2641.25,25.57,25.07
29/10/2018 15:30,31/10/2018 16:00,SPXW,Put,31/10/2018 0:00,2,2435,2125,23,-1.11,1,1.3,0,,,2507,46,713000,0.003516129,No,698467,700974,Yes,-0.0307,0.5566,2629.88,2711.74,26.35,21.16
31/10/2018 15:30,2/11/2018 16:00,SPXW,Put,2/11/2018 0:00,2,2590,2290,23,-0.79,0.7,0.95,0,,,1771,46,690000,0.002566667,No,700974,702745,Yes,-0.0294,0.3734,2729.01,2723.06,20.82,19.69
2/11/2018 15:30,5/11/2018 16:00,SPXW,Put,5/11/2018 0:00,3,2630,2330,23,-0.51,0.45,0.65,0,,,1127,46,690000,0.001633333,No,702745,703872,Yes,-0.0298,0.1995,2721.31,2738.31,19.98,19.93
5/11/2018 15:30,7/11/2018 16:00,SPXW,Put,7/11/2018 0:00,2,2600,2300,23,-1.26,1.15,1.45,0,,,2852,46,690000,0.004133333,No,703872,706724,Yes,-0.0405,0.3978,2737.33,2813.89,20.23,16.46
7/11/2018 15:30,9/11/2018 16:00,SPXW,Put,9/11/2018 0:00,2,2705,2405,24,-0.61,0.55,0.75,0,,,1416,48,720000,0.001966667,No,706724,708140,Yes,-0.0311,0.2732,2810.47,2781.01,16.67,17.32
9/11/2018 15:30,12/11/2018 16:00,SPXW,Put,12/11/2018 0:00,3,2700,2400,24,-0.46,0.4,0.6,0,,,1056,48,720000,0.001466667,No,708140,709196,Yes,-0.0295,0.1805,2784.74,2726.22,17.31,20.52
12/11/2018 15:30,14/11/2018 16:00,SPXW,Put,14/11/2018 0:00,2,2605,2300,23,-0.74,0.65,0.9,0,,,1656,46,701500,0.002360656,No,709196,710852,Yes,-0.029,0.3568,2739.65,2701.58,19.72,21.14
14/11/2018 15:30,16/11/2018 16:00,SPXW,Put,16/11/2018 0:00,2,2595,2295,24,-0.74,0.65,0.9,0,,,1728,48,720000,0.0024,No,710852,712580,Yes,-0.0315,0.328,2715.76,2736.27,20.53,18.66
16/11/2018 15:30,19/11/2018 16:00,SPXW,Put,19/11/2018 0:00,3,2660,2360,24,-0.41,0.35,0.55,0,,,936,48,720000,0.0013,No,712580,713516,Yes,-0.0283,0.1734,2741.03,2690.73,18.5,20.35
19/11/2018 15:30,21/11/2018 16:00,SPXW,Put,21/11/2018 0:00,2,2585,2280,23,-0.64,0.55,0.8,0,,,1426,46,701500,0.002032787,No,713516,714942,Yes,-0.0304,0.3029,2695.61,2649.93,20.18,20.69
21/11/2018 15:30,23/11/2018 16:00,SPXW,Put,23/11/2018 0:00,2,2580,2280,24,-0.39,0.3,0.55,0,,,888,48,720000,0.001233333,No,714942,715830,Yes,-0.029,0.2126,2658.73,2632.56,20.32,21.52
23/11/2018 15:30,26/11/2018 16:00,SPXW,Put,26/11/2018 0:00,3,2530,2225,23,-0.61,0.5,0.8,0,,,1357,46,701500,0.001934426,No,715830,717187,Yes,-0.0316,0.2267,2632.56,2673.45,21.52,18.74
26/11/2018 15:30,28/11/2018 16:00,SPXW,Put,28/11/2018 0:00,2,2575,2275,24,-0.46,0.4,0.6,0,,,1056,48,720000,0.001466667,No,717187,718243,Yes,-0.0291,0.255,2669.22,2743.79,19.18,18.32
28/11/2018 15:30,30/11/2018 16:00,SPXW,Put,30/11/2018 0:00,2,2635,2335,24,-0.49,0.4,0.65,0,,,1128,48,720000,0.001566667,No,718243,719371,Yes,-0.0282,0.2582,2733.87,2760.17,18.3,18.4
30/11/2018 15:30,3/12/2018 16:00,SPXW,Put,3/12/2018 0:00,3,2625,2330,24,-0.81,0.75,0.95,0,,,1896,48,708000,0.002677966,No,719371,721267,Yes,-0.0313,0.2908,2756.77,2790.37,18.55,16.31
3/12/2018 15:30,4/12/2018 16:00,SPXW,Put,4/12/2018 0:00,1,2725,2425,24,-0.36,0.3,0.5,24.94,,,-59040,48,720000,-0.082,Yes,721267,662227,Yes,-0.0309,0.1688,2789.49,2700.06,16.37,20.77
4/12/2018 15:30,7/12/2018 16:00,SPXW,Put,7/12/2018 0:00,3,2510,2210,22,-1.06,0.95,1.25,0,,,2288,44,660000,0.003466667,No,662227,664515,Yes,-0.0295,0.4381,2705.15,2633.08,20.65,23.35
7/12/2018 15:30,10/12/2018 16:00,SPXW,Put,10/12/2018 0:00,3,2465,2175,23,-0.96,0.85,1.15,0,,,2162,46,667000,0.003241379,No,664515,666677,Yes,-0.0297,0.3936,2636.2,2637.72,23.39,22.6
10/12/2018 15:30,12/12/2018 16:00,SPXW,Put,12/12/2018 0:00,2,2470,2175,23,-0.86,0.75,1.05,0,,,1932,46,678500,0.002847458,No,666677,668609,Yes,-0.0292,0.4557,2632.87,2651.07,23.16,21.44
12/12/2018 15:30,14/12/2018 16:00,SPXW,Put,14/12/2018 0:00,2,2545,2245,22,-0.69,0.6,0.85,0,,,1474,44,660000,0.002233333,No,668609,670083,Yes,-0.0311,0.3195,2660.54,2599.95,21.23,22
14/12/2018 15:30,17/12/2018 16:00,SPXW,Put,17/12/2018 0:00,3,2485,2175,22,-0.64,0.55,0.8,0,,,1364,44,682000,0.002,No,670083,671447,Yes,-0.0294,0.2664,2601.36,2545.94,22.08,25.03
17/12/2018 15:30,19/12/2018 16:00,SPXW,Put,19/12/2018 0:00,2,2340,2050,23,-1.11,1.05,1.25,0,,,2507,46,667000,0.003758621,No,671447,673954,Yes,-0.0307,0.5977,2541.55,2506.96,25.34,24.94
19/12/2018 15:30,21/12/2018 16:00,SPXW,Put,21/12/2018 0:00,2,2305,2000,22,-1.11,0.95,1.35,0,,,2398,44,671000,0.00357377,No,673954,676352,Yes,-0.0296,0.5865,2501.8,2416.62,25.42,29.79
21/12/2018 15:30,24/12/2018 16:00,SPXW,Put,24/12/2018 0:00,3,2200,1900,23,-0.89,0.75,1.1,0,,,2001,46,690000,0.0029,No,676352,678353,Yes,-0.0234,0.5227,2416.55,2351.1,30.07,36.07
26/12/2018 9:31,28/12/2018 16:00,SPXW,Put,28/12/2018 0:00,2,2150,1850,23,-1.41,1.3,1.6,0,,,3197,46,690000,0.004633333,No,678353,681550,Yes,-0.0307,0.6774,2372.23,2485.74,35.45,28.44
28/12/2018 15:30,31/12/2018 16:00,SPXW,Put,31/12/2018 0:00,3,2350,2040,22,-0.81,0.7,1,0,,,1738,44,682000,0.002548387,No,681550,683288,Yes,-0.0304,0.3321,2487.25,2506.85,28.87,26.14
2/1/2019 9:31,4/1/2019 16:00,SPXW,Put,4/1/2019 0:00,2,2295,1990,22,-1.01,0.9,1.2,0,,,2178,44,671000,0.003245902,No,683288,685466,Yes,-0.0292,0.4918,2470.98,2531.94,26.27,21.27
4/1/2019 15:30,7/1/2019 16:00,SPXW,Put,7/1/2019 0:00,3,2430,2130,23,-0.51,0.45,0.65,0,,,1127,46,690000,0.001633333,No,685466,686593,Yes,-0.0289,0.2225,2524.54,2549.69,22,21.19
7/1/2019 15:30,9/1/2019 16:00,SPXW,Put,9/1/2019 0:00,2,2450,2150,23,-0.61,0.55,0.75,0,,,1357,46,690000,0.001966667,No,686593,687950,Yes,-0.0299,0.3028,2556.72,2584.96,20.97,19.82
9/1/2019 15:30,11/1/2019 16:00,SPXW,Put,11/1/2019 0:00,2,2490,2190,23,-0.56,0.5,0.7,0,,,1242,46,690000,0.0018,No,687950,689192,Yes,-0.0294,0.2817,2590.2,2596.26,19.54,18.18
11/1/2019 15:30,14/1/2019 16:00,SPXW,Put,14/1/2019 0:00,3,2525,2225,23,-0.28,0.25,0.4,0,,,598,46,690000,0.000866667,No,689192,689790,Yes,-0.027,0.143,2589.59,2582.61,18.62,18.79
14/1/2019 15:30,16/1/2019 16:00,SPXW,Put,16/1/2019 0:00,2,2505,2205,23,-0.43,0.4,0.55,0,,,943,46,690000,0.001366667,No,689790,690733,Yes,-0.0295,0.2252,2585.36,2616.1,18.83,18.7
16/1/2019 15:30,18/1/2019 16:00,SPXW,Put,18/1/2019 0:00,2,2535,2235,23,-0.51,0.45,0.65,0,,,1127,46,690000,0.001633333,No,690733,691860,Yes,-0.0304,0.2469,2623.81,2670.71,18.34,17.73
18/1/2019 15:30,22/1/2019 16:00,SPXW,Put,22/1/2019 0:00,4,2600,2300,23,-0.33,0.3,0.45,0,,,713,46,690000,0.001033333,No,691860,692573,Yes,-0.0292,0.1263,2665.86,2632.9,17.99,20.59
22/1/2019 15:30,23/1/2019 16:00,SPXW,Put,23/1/2019 0:00,1,2565,2265,23,-0.36,0.3,0.5,0,,,782,46,690000,0.001133333,No,692573,693355,Yes,-0.0323,0.2387,2625.76,2638.7,20.64,19.63
23/1/2019 15:30,25/1/2019 16:00,SPXW,Put,25/1/2019 0:00,2,2555,2255,23,-0.48,0.45,0.6,0,,,1058,46,690000,0.001533333,No,693355,694413,Yes,-0.0307,0.2322,2638.24,2664.76,19.83,17.46
25/1/2019 15:30,28/1/2019 16:00,SPXW,Put,28/1/2019 0:00,3,2605,2305,23,-0.26,0.2,0.4,0,,,552,46,690000,0.0008,No,694413,694965,Yes,-0.0278,0.1251,2662.35,2643.85,17.47,18.97
28/1/2019 15:30,30/1/2019 16:00,SPXW,Put,30/1/2019 0:00,2,2550,2250,23,-0.51,0.45,0.65,0,,,1127,46,690000,0.001633333,No,694965,696092,Yes,-0.0299,0.2501,2641.23,2681.05,19.11,17.68
30/1/2019 15:30,31/1/2019 16:00,SPXW,Put,31/1/2019 0:00,1,2615,2315,23,-0.28,0.25,0.4,0,,,598,46,690000,0.000866667,No,696092,696690,Yes,-0.0269,0.2376,2679.91,2704.1,17.73,16.65
31/1/2019 15:30,1/2/2019 16:00,SPXW,Put,1/2/2019 0:00,1,2635,2335,23,-0.38,0.35,0.5,0,,,828,46,690000,0.0012,No,696690,697518,Yes,-0.0328,0.2416,2698.35,2706.53,16.87,16.16
1/2/2019 15:30,4/2/2019 16:00,SPXW,Put,4/2/2019 0:00,3,2650,2350,23,-0.31,0.3,0.4,0,,,667,46,690000,0.000966667,No,697518,698185,Yes,-0.0334,0.1154,2701.38,2724.87,16.36,15.71
4/2/2019 15:30,6/2/2019 16:00,SPXW,Put,6/2/2019 0:00,2,2660,2360,23,-0.33,0.3,0.45,0,,,713,46,690000,0.001033333,No,698185,698898,Yes,-0.0319,0.1574,2718.52,2731.61,15.72,15.42
6/2/2019 15:30,8/2/2019 16:00,SPXW,Put,8/2/2019 0:00,2,2665,2365,23,-0.38,0.35,0.5,0,,,828,46,690000,0.0012,No,698898,699726,Yes,-0.0317,0.1773,2731.85,2707.88,15.46,15.77
8/2/2019 15:30,11/2/2019 16:00,SPXW,Put,11/2/2019 0:00,3,2645,2345,23,-0.31,0.25,0.45,0,,,667,46,690000,0.000966667,No,699726,700393,Yes,-0.0314,0.1239,2701.05,2709.8,16.02,15.9
11/2/2019 15:30,13/2/2019 16:00,SPXW,Put,13/2/2019 0:00,2,2635,2330,23,-0.43,0.4,0.55,0,,,943,46,701500,0.001344262,No,700393,701336,Yes,-0.0312,0.2023,2710,2753.03,16,15.48
13/2/2019 15:30,15/2/2019 16:00,SPXW,Put,15/2/2019 0:00,2,2675,2375,23,-0.46,0.45,0.55,0,,,1012,46,690000,0.001466667,No,701336,702348,Yes,-0.0299,0.2185,2758.25,2775.6,15.25,14.89
15/2/2019 15:30,19/2/2019 16:00,SPXW,Put,19/2/2019 0:00,4,2705,2405,23,-0.31,0.25,0.45,0,,,667,46,690000,0.000966667,No,702348,703015,Yes,-0.0287,0.1161,2768.34,2779.76,14.93,14.87
19/2/2019 15:30,20/2/2019 16:00,SPXW,Put,20/2/2019 0:00,1,2740,2440,23,-0.23,0.2,0.35,0,,,483,46,690000,0.0007,No,703015,703498,Yes,-0.032,0.1607,2784.25,2784.7,14.8,14.22
20/2/2019 15:30,22/2/2019 16:00,SPXW,Put,22/2/2019 0:00,2,2720,2420,23,-0.33,0.3,0.45,0,,,713,46,690000,0.001033333,No,703498,704211,Yes,-0.0295,0.1676,2784.55,2792.67,14.23,13.61
22/2/2019 15:30,25/2/2019 16:00,SPXW,Put,25/2/2019 0:00,3,2735,2430,23,-0.23,0.2,0.35,0,,,483,46,701500,0.000688525,No,704211,704694,Yes,-0.0273,0.1126,2789.55,2796.11,13.67,14.88
25/2/2019 15:30,27/2/2019 16:00,SPXW,Put,27/2/2019 0:00,2,2725,2425,23,-0.38,0.35,0.5,0,,,828,46,690000,0.0012,No,704694,705522,Yes,-0.0299,0.185,2796.67,2792.38,14.51,14.86
27/2/2019 15:30,28/2/2019 16:00,SPXW,Put,28/2/2019 0:00,1,2745,2445,24,-0.23,0.2,0.35,0,,,504,48,720000,0.0007,No,705522,706026,Yes,-0.031,0.1664,2791.05,2784.49,14.94,15.1
28/2/2019 15:30,1/3/2019 16:00,SPXW,Put,1/3/2019 0:00,1,2735,2435,24,-0.23,0.2,0.35,0,,,504,48,720000,0.0007,No,706026,706530,Yes,-0.0276,0.19,2788.48,2803.69,14.79,13.51
1/3/2019 15:30,4/3/2019 16:00,SPXW,Put,4/3/2019 0:00,3,2755,2455,24,-0.23,0.2,0.35,0,,,504,48,720000,0.0007,No,706530,707034,Yes,-0.0306,0.0984,2801.35,2792.81,13.53,14.51
4/3/2019 15:30,6/3/2019 16:00,SPXW,Put,6/3/2019 0:00,2,2710,2410,24,-0.38,0.35,0.5,0,,,864,48,720000,0.0012,No,707034,707898,Yes,-0.0284,0.1967,2786.63,2771.45,14.88,15.69
6/3/2019 15:30,8/3/2019 16:00,SPXW,Put,8/3/2019 0:00,2,2685,2385,24,-0.43,0.4,0.55,0,,,984,48,720000,0.001366667,No,707898,708882,Yes,-0.0281,0.2224,2771.13,2743.07,15.81,16.28
8/3/2019 15:30,11/3/2019 16:00,SPXW,Put,11/3/2019 0:00,3,2665,2360,23,-0.36,0.3,0.5,0,,,782,46,701500,0.001114754,No,708882,709664,Yes,-0.0302,0.1449,2731.86,2783.3,16.97,14.42
11/3/2019 15:30,13/3/2019 16:00,SPXW,Put,13/3/2019 0:00,2,2710,2410,24,-0.41,0.35,0.55,0,,,936,48,720000,0.0013,No,709664,710600,Yes,-0.0313,0.1862,2780.78,2810.92,14.52,13.6
13/3/2019 15:30,15/3/2019 16:00,SPXW,Put,15/3/2019 0:00,2,2730,2430,24,-0.41,0.35,0.55,0,,,936,48,720000,0.0013,No,710600,711536,Yes,-0.0295,0.2073,2811.42,2822.48,13.78,12.95
15/3/2019 15:30,18/3/2019 16:00,SPXW,Put,18/3/2019 0:00,3,2780,2480,24,-0.23,0.2,0.35,0,,,504,48,720000,0.0007,No,711536,712040,Yes,-0.032,0.093,2823.81,2832.94,12.81,13.16
18/3/2019 15:30,20/3/2019 16:00,SPXW,Put,20/3/2019 0:00,2,2765,2465,24,-0.28,0.25,0.4,0,,,624,48,720000,0.000866667,No,712040,712664,Yes,-0.0271,0.1591,2828.43,2824.23,13.16,13.68
20/3/2019 15:30,22/3/2019 16:00,SPXW,Put,22/3/2019 0:00,2,2765,2465,24,-0.38,0.35,0.5,0,,,864,48,720000,0.0012,No,712664,713528,Yes,-0.0304,0.179,2834.56,2800.71,13.36,17.05
22/3/2019 15:30,25/3/2019 16:00,SPXW,Put,25/3/2019 0:00,3,2730,2430,24,-0.46,0.4,0.6,0,,,1056,48,720000,0.001466667,No,713528,714584,Yes,-0.0314,0.1742,2811.76,2798.36,16.19,16.51
25/3/2019 15:30,27/3/2019 16:00,SPXW,Put,27/3/2019 0:00,2,2715,2410,23,-0.48,0.45,0.6,0,,,1058,46,701500,0.001508197,No,714584,715642,Yes,-0.0302,0.2227,2800.42,2805.37,16.55,15.25
27/3/2019 15:30,29/3/2019 16:00,SPXW,Put,29/3/2019 0:00,2,2720,2420,24,-0.43,0.4,0.55,0,,,984,48,720000,0.001366667,No,715642,716626,Yes,-0.0276,0.2239,2808.06,2834.4,15.2,13.85
29/3/2019 15:30,1/4/2019 16:00,SPXW,Put,1/4/2019 0:00,3,2775,2475,24,-0.28,0.25,0.4,0,,,624,48,720000,0.000866667,No,716626,717250,Yes,-0.0302,0.115,2829.79,2867.19,13.8,13.4
1/4/2019 15:30,3/4/2019 16:00,SPXW,Put,3/4/2019 0:00,2,2805,2500,24,-0.36,0.35,0.45,0,,,816,48,732000,0.001114754,No,717250,718066,Yes,-0.0325,0.1551,2865.27,2873.4,13.51,13.78
3/4/2019 15:30,5/4/2019 16:00,SPXW,Put,5/4/2019 0:00,2,2795,2495,24,-0.43,0.4,0.55,0,,,984,48,720000,0.001366667,No,718066,719050,Yes,-0.0311,0.1918,2870.25,2892.74,13.98,12.77
5/4/2019 15:30,8/4/2019 16:00,SPXW,Put,8/4/2019 0:00,3,2850,2550,24,-0.23,0.2,0.35,0,,,504,48,720000,0.0007,No,719050,719554,Yes,-0.0332,0.087,2891.71,2895.77,12.84,13.13
8/4/2019 15:30,10/4/2019 16:00,SPXW,Put,10/4/2019 0:00,2,2840,2540,24,-0.21,0.2,0.3,0,,,456,48,720000,0.000633333,No,719554,720010,Yes,-0.0267,0.1247,2892.17,2888.21,13.15,13.39
10/4/2019 15:30,12/4/2019 16:00,SPXW,Put,12/4/2019 0:00,2,2835,2535,24,-0.28,0.25,0.4,0,,,624,48,720000,0.000866667,No,720010,720634,Yes,-0.0311,0.1335,2887.47,2907.41,13.39,12.06
12/4/2019 15:30,15/4/2019 16:00,SPXW,Put,15/4/2019 0:00,3,2865,2565,24,-0.23,0.2,0.35,0,,,504,48,720000,0.0007,No,720634,721138,Yes,-0.0337,0.0849,2905.25,2905.58,12.13,12.3
15/4/2019 15:30,17/4/2019 16:00,SPXW,Put,17/4/2019 0:00,2,2845,2545,24,-0.33,0.3,0.45,0,,,744,48,720000,0.001033333,No,721138,721882,Yes,-0.0308,0.153,2905.32,2900.45,12.29,12.43
17/4/2019 15:30,18/4/2019 16:00,SPXW,Put,18/4/2019 0:00,1,2850,2550,24,-0.23,0.2,0.35,0,,,504,48,720000,0.0007,No,721882,722386,Yes,-0.0287,0.1748,2900.74,2905.03,12.42,12.13
18/4/2019 15:30,22/4/2019 16:00,SPXW,Put,22/4/2019 0:00,4,2860,2560,24,-0.21,0.2,0.3,0,,,456,48,720000,0.000633333,No,722386,722842,Yes,-0.0283,0.0825,2907.62,2907.97,12.17,12.45
22/4/2019 15:30,24/4/2019 16:00,SPXW,Put,24/4/2019 0:00,2,2850,2550,24,-0.28,0.25,0.4,0,,,624,48,720000,0.000866667,No,722842,723466,Yes,-0.0301,0.1378,2905.29,2927.25,12.53,13.05
24/4/2019 15:30,26/4/2019 16:00,SPXW,Put,26/4/2019 0:00,2,2865,2565,24,-0.36,0.35,0.45,0,,,816,48,720000,0.001133333,No,723466,724282,Yes,-0.0298,0.1676,2932.52,2939.88,12.7,12.6
26/4/2019 15:30,29/4/2019 16:00,SPXW,Put,29/4/2019 0:00,3,2880,2580,24,-0.28,0.25,0.4,0,,,624,48,720000,0.000866667,No,724282,724906,Yes,-0.0308,0.1089,2933.86,2943.03,12.69,13
29/4/2019 15:30,30/4/2019 16:00,SPXW,Put,30/4/2019 0:00,1,2895,2595,24,-0.28,0.25,0.4,0,,,624,48,720000,0.000866667,No,724906,725530,Yes,-0.0319,0.1777,2946.1,2945.83,13.02,13.08
30/4/2019 15:30,1/5/2019 16:00,SPXW,Put,1/5/2019 0:00,1,2890,2590,24,-0.28,0.25,0.4,0,,,624,48,720000,0.000866667,No,725530,726154,Yes,-0.0316,0.1801,2941.79,2923.73,13.08,14.43
1/5/2019 15:30,3/5/2019 16:00,SPXW,Put,3/5/2019 0:00,2,2845,2545,24,-0.53,0.5,0.65,0,,,1224,48,720000,0.0017,No,726154,727378,Yes,-0.0301,0.2325,2938.35,2945.64,13.45,12.96
3/5/2019 15:30,6/5/2019 16:00,SPXW,Put,6/5/2019 0:00,3,2890,2590,24,-0.23,0.2,0.35,0,,,504,48,720000,0.0007,No,727378,727882,Yes,-0.0275,0.1059,2944.37,2932.47,13.12,15.31
6/5/2019 15:30,8/5/2019 16:00,SPXW,Put,8/5/2019 0:00,2,2835,2530,24,-0.51,0.45,0.65,0,,,1176,48,732000,0.001606557,No,727882,729058,Yes,-0.0288,0.2453,2934.76,2879.42,15.14,20.06
8/5/2019 15:30,10/5/2019 16:00,SPXW,Put,10/5/2019 0:00,2,2760,2455,24,-0.79,0.7,0.95,0,,,1848,48,732000,0.00252459,No,729058,730906,Yes,-0.0302,0.3419,2895.97,2881.4,18.84,16.09
10/5/2019 15:30,13/5/2019 16:00,SPXW,Put,13/5/2019 0:00,3,2800,2500,24,-0.56,0.5,0.7,0,,,1296,48,720000,0.0018,No,730906,732202,Yes,-0.0323,0.1866,2889.1,2811.87,15.63,20.17
13/5/2019 15:30,15/5/2019 16:00,SPXW,Put,15/5/2019 0:00,2,2680,2375,24,-0.69,0.6,0.85,0,,,1608,48,732000,0.002196721,No,732202,733810,Yes,-0.0285,0.3339,2810.42,2850.96,20.13,16.6
15/5/2019 15:30,17/5/2019 16:00,SPXW,Put,17/5/2019 0:00,2,2760,2460,24,-0.53,0.5,0.65,0,,,1224,48,720000,0.0017,No,733810,735034,Yes,-0.0294,0.2458,2857.81,2859.53,16.46,16.08
17/5/2019 15:30,20/5/2019 16:00,SPXW,Put,20/5/2019 0:00,3,2780,2480,25,-0.48,0.45,0.6,0,,,1150,50,750000,0.001533333,No,735034,736184,Yes,-0.0305,0.1766,2864.69,2840.23,15.8,16.32
20/5/2019 15:30,22/5/2019 16:00,SPXW,Put,22/5/2019 0:00,2,2750,2450,25,-0.46,0.4,0.6,0,,,1100,50,750000,0.001466667,No,736184,737284,Yes,-0.0286,0.2232,2838,2856.27,16.6,14.76
22/5/2019 15:30,24/5/2019 16:00,SPXW,Put,24/5/2019 0:00,2,2785,2485,25,-0.33,0.3,0.45,0,,,775,50,750000,0.001033333,No,737284,738059,Yes,-0.0264,0.1853,2860.48,2826.06,14.65,16.2
24/5/2019 15:30,28/5/2019 16:00,SPXW,Put,28/5/2019 0:00,4,2755,2450,24,-0.41,0.35,0.55,0,,,936,48,732000,0.001278689,No,738059,738995,Yes,-0.0299,0.1373,2830.41,2802.39,15.9,17.51
28/5/2019 15:30,29/5/2019 16:00,SPXW,Put,29/5/2019 0:00,1,2750,2450,25,-0.33,0.3,0.45,0,,,775,50,750000,0.001033333,No,738995,739770,Yes,-0.0308,0.2216,2810.77,2783.02,17.12,17.76
29/5/2019 15:30,31/5/2019 16:00,SPXW,Put,31/5/2019 0:00,2,2675,2375,25,-0.53,0.5,0.65,0,,,1275,50,750000,0.0017,No,739770,741045,Yes,-0.0283,0.2634,2777.02,2752.06,18.09,18.71
31/5/2019 15:30,3/6/2019 16:00,SPXW,Put,3/6/2019 0:00,3,2665,2370,25,-0.48,0.45,0.6,0,,,1150,50,737500,0.001559322,No,741045,742195,Yes,-0.0293,0.1924,2754.84,2744.45,18.71,19.07
3/6/2019 15:30,5/6/2019 16:00,SPXW,Put,5/6/2019 0:00,2,2640,2340,25,-0.49,0.4,0.65,0,,,1175,50,750000,0.001566667,No,742195,743370,Yes,-0.0292,0.2478,2733.69,2826.15,19.47,16.16
5/6/2019 15:30,7/6/2019 16:00,SPXW,Put,7/6/2019 0:00,2,2740,2440,25,-0.46,0.4,0.6,0,,,1100,50,750000,0.001466667,No,743370,744470,Yes,-0.0305,0.2091,2821.57,2873.34,16.36,16.28
7/6/2019 15:30,10/6/2019 16:00,SPXW,Put,10/6/2019 0:00,3,2810,2510,25,-0.33,0.3,0.45,0,,,775,50,750000,0.001033333,No,744470,745245,Yes,-0.0282,0.1398,2878.7,2886.73,16.08,16.07
10/6/2019 15:30,12/6/2019 16:00,SPXW,Put,12/6/2019 0:00,2,2815,2515,25,-0.38,0.35,0.5,0,,,900,50,750000,0.0012,No,745245,746145,Yes,-0.029,0.1854,2889.18,2879.84,16.1,15.96
12/6/2019 15:30,14/6/2019 16:00,SPXW,Put,14/6/2019 0:00,2,2810,2510,25,-0.33,0.3,0.45,0,,,775,50,750000,0.001033333,No,746145,746920,Yes,-0.0284,0.1696,2878.66,2886.98,15.88,15.34
14/6/2019 15:30,17/6/2019 16:00,SPXW,Put,17/6/2019 0:00,3,2840,2540,25,-0.23,0.2,0.35,0,,,525,50,750000,0.0007,No,746920,747445,Yes,-0.0279,0.1059,2892.49,2889.67,15.38,15.48
17/6/2019 15:30,19/6/2019 16:00,SPXW,Put,19/6/2019 0:00,2,2820,2520,25,-0.38,0.35,0.5,0,,,900,50,750000,0.0012,No,747445,748345,Yes,-0.0292,0.1839,2893.75,2926.46,15.33,14.28
19/6/2019 15:30,21/6/2019 16:00,SPXW,Put,21/6/2019 0:00,2,2845,2545,25,-0.44,0.4,0.55,0,,,1050,50,750000,0.0014,No,748345,749395,Yes,-0.0299,0.2059,2928.01,2950.46,14.24,15.46
21/6/2019 15:30,24/6/2019 16:00,SPXW,Put,24/6/2019 0:00,3,2885,2585,25,-0.33,0.3,0.45,0,,,775,50,750000,0.001033333,No,749395,750170,Yes,-0.0277,0.1392,2955.37,2945.35,15.04,15.4
24/6/2019 15:30,26/6/2019 16:00,SPXW,Put,26/6/2019 0:00,2,2885,2585,25,-0.36,0.35,0.45,0,,,850,50,750000,0.001133333,No,750170,751020,Yes,-0.0316,0.1555,2947.12,2913.78,15.36,16.27
26/6/2019 15:30,28/6/2019 16:00,SPXW,Put,28/6/2019 0:00,2,2835,2535,25,-0.43,0.4,0.55,0,,,1025,50,750000,0.001366667,No,751020,752045,Yes,-0.0294,0.2011,2916.12,2941.76,16.33,15.6
28/6/2019 15:30,1/7/2019 16:00,SPXW,Put,1/7/2019 0:00,3,2815,2520,25,-0.66,0.6,0.8,0,,,1600,50,737500,0.002169492,No,752045,753645,Yes,-0.0293,0.2377,2931.85,2964.33,16.04,14.11
1/7/2019 15:30,3/7/2019 16:00,SPXW,Put,3/7/2019 0:00,2,2895,2595,25,-0.31,0.25,0.45,0,,,725,50,750000,0.000966667,No,753645,754370,Yes,-0.0279,0.1578,2960.48,2995.82,14.15,12.57
3/7/2019 15:30,5/7/2019 16:00,SPXW,Put,5/7/2019 0:00,2,2940,2640,25,-0.26,0.2,0.4,0,,,600,50,750000,0.0008,No,754370,754970,Yes,-0.0278,0.1357,2995.82,2990.41,12.57,13.19
5/7/2019 15:30,8/7/2019 16:00,SPXW,Put,8/7/2019 0:00,3,2945,2645,25,-0.18,0.15,0.3,0,,,400,50,750000,0.000533333,No,754970,755370,Yes,-0.0269,0.0891,2991.15,2975.95,13.17,13.92
8/7/2019 15:30,10/7/2019 16:00,SPXW,Put,10/7/2019 0:00,2,2915,2615,25,-0.33,0.3,0.45,0,,,775,50,750000,0.001033333,No,755370,756145,Yes,-0.0311,0.148,2975.91,2993.07,13.87,13.11
10/7/2019 15:30,12/7/2019 16:00,SPXW,Put,12/7/2019 0:00,2,2930,2630,25,-0.36,0.3,0.5,0,,,850,50,750000,0.001133333,No,756145,756995,Yes,-0.0319,0.1516,2991.22,3013.77,13.16,12.32
12/7/2019 15:30,15/7/2019 16:00,SPXW,Put,15/7/2019 0:00,3,2965,2665,25,-0.21,0.15,0.35,0,,,475,50,750000,0.000633333,No,756995,757470,Yes,-0.0295,0.0877,3009.6,3014.3,12.4,12.75
15/7/2019 15:30,17/7/2019 16:00,SPXW,Put,17/7/2019 0:00,2,2945,2645,25,-0.33,0.3,0.45,0,,,775,50,750000,0.001033333,No,757470,758245,Yes,-0.0287,0.1598,3011.85,2984.42,12.76,13.69
17/7/2019 15:30,19/7/2019 16:00,SPXW,Put,19/7/2019 0:00,2,2905,2605,25,-0.41,0.35,0.55,0,,,975,50,750000,0.0013,No,758245,759220,Yes,-0.0287,0.2011,2988.36,2976.61,13.5,14.29
19/7/2019 15:30,22/7/2019 16:00,SPXW,Put,22/7/2019 0:00,3,2920,2620,25,-0.34,0.25,0.5,0,,,800,50,750000,0.001066667,No,759220,760020,Yes,-0.0312,0.128,2983.87,2985.03,14.12,13.48
22/7/2019 15:30,24/7/2019 16:00,SPXW,Put,24/7/2019 0:00,2,2920,2620,25,-0.31,0.25,0.45,0,,,725,50,750000,0.000966667,No,760020,760745,Yes,-0.0291,0.1589,2986.05,3019.56,13.55,12.12
24/7/2019 15:30,26/7/2019 16:00,SPXW,Put,26/7/2019 0:00,2,2950,2650,25,-0.36,0.35,0.45,0,,,850,50,750000,0.001133333,No,760745,761595,Yes,-0.0298,0.1623,3017.39,3025.86,12.01,12.09
26/7/2019 15:30,29/7/2019 16:00,SPXW,Put,29/7/2019 0:00,3,2980,2680,25,-0.23,0.2,0.35,0,,,525,50,750000,0.0007,No,761595,762120,Yes,-0.0305,0.0913,3026.54,3020.97,12.1,12.89
29/7/2019 15:30,31/7/2019 16:00,SPXW,Put,31/7/2019 0:00,2,2940,2640,25,-0.43,0.4,0.55,0,,,1025,50,750000,0.001366667,No,762120,763145,Yes,-0.0298,0.1911,3019.72,2980.38,12.78,15.44
31/7/2019 15:30,2/8/2019 16:00,SPXW,Put,2/8/2019 0:00,2,2875,2575,25,-0.66,0.6,0.8,0,,,1600,50,750000,0.002133333,No,763145,764745,Yes,-0.0302,0.2937,2995.76,2932.05,14.37,18.19
2/8/2019 15:30,5/8/2019 16:00,SPXW,Put,5/8/2019 0:00,3,2800,2500,25,-0.73,0.7,0.85,0,,,1775,50,750000,0.002366667,No,764745,766520,Yes,-0.0299,0.2721,2933.38,2844.74,18.15,23.28
5/8/2019 15:30,7/8/2019 16:00,SPXW,Put,7/8/2019 0:00,2,2600,2300,26,-0.93,0.9,1.05,0,,,2366,52,780000,0.003033333,No,766520,768886,Yes,-0.0231,0.5918,2838.19,2883.98,23.65,19.34
7/8/2019 15:30,9/8/2019 16:00,SPXW,Put,9/8/2019 0:00,2,2750,2450,26,-0.84,0.75,1,0,,,2132,52,780000,0.002733333,No,768886,771018,Yes,-0.0313,0.3484,2886.73,2918.65,19.23,18.07
9/8/2019 15:30,12/8/2019 16:00,SPXW,Put,12/8/2019 0:00,3,2830,2530,26,-0.61,0.55,0.75,0,,,1534,52,780000,0.001966667,No,771018,772552,Yes,-0.0319,0.2014,2927.8,2882.7,17.57,20.65
12/8/2019 15:30,14/8/2019 16:00,SPXW,Put,14/8/2019 0:00,2,2745,2450,26,-0.73,0.7,0.85,0,,,1846,52,767000,0.00240678,No,772552,774398,Yes,-0.0293,0.3453,2881.07,2840.6,20.49,22.28
14/8/2019 15:30,16/8/2019 16:00,SPXW,Put,16/8/2019 0:00,2,2685,2385,26,-0.99,0.9,1.15,0,,,2522,52,780000,0.003233333,No,774398,776920,Yes,-0.0305,0.4224,2848.6,2888.68,21.87,18.63
16/8/2019 15:30,19/8/2019 16:00,SPXW,Put,19/8/2019 0:00,3,2795,2490,25,-0.46,0.45,0.55,0,,,1100,50,762500,0.001442623,No,776920,778020,Yes,-0.0279,0.1853,2886.67,2923.65,18.74,16.66
19/8/2019 15:30,21/8/2019 16:00,SPXW,Put,21/8/2019 0:00,2,2830,2530,26,-0.53,0.5,0.65,0,,,1326,52,780000,0.0017,No,778020,779346,Yes,-0.0295,0.2388,2926.45,2924.43,16.77,15.98
21/8/2019 15:30,23/8/2019 16:00,SPXW,Put,23/8/2019 0:00,2,2820,2520,26,-0.53,0.5,0.65,0,,,1326,52,780000,0.0017,No,779346,780672,Yes,-0.0281,0.2529,2922.66,2847.11,15.94,20.52
26/8/2019 9:31,28/8/2019 16:00,SPXW,Put,28/8/2019 0:00,2,2715,2425,27,-0.86,0.75,1.05,0,,,2268,54,783000,0.002896552,No,780672,782940,Yes,-0.0287,0.3736,2870.41,2887.94,19.87,19.33
28/8/2019 15:30,30/8/2019 16:00,SPXW,Put,30/8/2019 0:00,2,2765,2460,26,-0.66,0.6,0.8,0,,,1664,52,793000,0.002098361,No,782940,784604,Yes,-0.0295,0.3026,2885.05,2926.46,19.54,18.63
30/8/2019 15:30,3/9/2019 16:00,SPXW,Put,3/9/2019 0:00,4,2805,2510,27,-0.71,0.65,0.85,0,,,1863,54,796500,0.002338983,No,784604,786467,Yes,-0.0308,0.209,2922.09,2906.27,18.58,19.63
3/9/2019 15:30,4/9/2019 16:00,SPXW,Put,4/9/2019 0:00,1,2835,2530,26,-0.41,0.35,0.55,0,,,1014,52,793000,0.001278689,No,786467,787481,Yes,-0.0323,0.2416,2903.44,2937.78,19.89,17.34
4/9/2019 15:30,6/9/2019 16:00,SPXW,Put,6/9/2019 0:00,2,2840,2540,26,-0.48,0.45,0.6,0,,,1196,52,780000,0.001533333,No,787481,788677,Yes,-0.0279,0.2328,2935.76,2978.71,17.47,15.11
6/9/2019 15:30,9/9/2019 16:00,SPXW,Put,9/9/2019 0:00,3,2925,2625,26,-0.28,0.25,0.4,0,,,676,52,780000,0.000866667,No,788677,789353,Yes,-0.0289,0.1148,2983.44,2978.43,14.94,15.26
9/9/2019 15:30,11/9/2019 16:00,SPXW,Put,11/9/2019 0:00,2,2910,2610,26,-0.31,0.25,0.45,0,,,754,52,780000,0.000966667,No,789353,790107,Yes,-0.0275,0.1595,2976.74,3000.93,15.46,14.69
11/9/2019 15:30,13/9/2019 16:00,SPXW,Put,13/9/2019 0:00,2,2920,2620,26,-0.41,0.4,0.5,0,,,1014,52,780000,0.0013,No,790107,791121,Yes,-0.0305,0.1781,2993.89,3007.39,14.65,13.86
13/9/2019 15:30,16/9/2019 16:00,SPXW,Put,16/9/2019 0:00,3,2940,2640,26,-0.38,0.35,0.5,0,,,936,52,780000,0.0012,No,791121,792057,Yes,-0.0317,0.1319,3005.73,2997.96,14.1,14.79
16/9/2019 15:30,18/9/2019 16:00,SPXW,Put,18/9/2019 0:00,2,2900,2600,26,-0.58,0.55,0.7,0,,,1456,52,780000,0.001866667,No,792057,793513,Yes,-0.0312,0.237,2996.95,3006.73,14.76,14.06
18/9/2019 15:30,20/9/2019 16:00,SPXW,Put,20/9/2019 0:00,2,2875,2575,26,-0.68,0.65,0.8,0,,,1716,52,780000,0.0022,No,793513,795229,Yes,-0.0307,0.2967,2995.92,2992.07,14.54,15.21
20/9/2019 15:30,23/9/2019 16:00,SPXW,Put,23/9/2019 0:00,3,2900,2600,27,-0.51,0.45,0.65,0,,,1323,54,810000,0.001633333,No,795229,796552,Yes,-0.0286,0.1901,2996.48,2991.78,15.06,15.13
23/9/2019 15:30,25/9/2019 16:00,SPXW,Put,25/9/2019 0:00,2,2930,2630,27,-0.38,0.35,0.5,0,,,972,54,810000,0.0012,No,796552,797524,Yes,-0.031,0.1655,2998.06,2984.87,14.79,15.88
25/9/2019 15:30,27/9/2019 16:00,SPXW,Put,27/9/2019 0:00,2,2885,2585,27,-0.53,0.5,0.65,0,,,1377,54,810000,0.0017,No,797524,798901,Yes,-0.0285,0.2433,2986.05,2961.79,15.95,17.26
27/9/2019 15:30,30/9/2019 16:00,SPXW,Put,30/9/2019 0:00,3,2850,2550,27,-0.53,0.5,0.65,0,,,1377,54,810000,0.0017,No,798901,800278,Yes,-0.0284,0.203,2952.13,2976.74,17.93,16.55
30/9/2019 15:30,2/10/2019 16:00,SPXW,Put,2/10/2019 0:00,2,2890,2590,27,-0.48,0.45,0.6,2.39,,,-5211,54,810000,-0.006433333,Yes,800278,795067,Yes,-0.0294,0.2159,2978.64,2887.61,16.61,20.39
2/10/2019 15:30,4/10/2019 16:00,SPXW,Put,4/10/2019 0:00,2,2780,2480,27,-0.61,0.6,0.7,0,,,1593,54,810000,0.001966667,No,795067,796660,Yes,-0.0287,0.2804,2892.63,2952.01,20.04,16.99
4/10/2019 15:30,7/10/2019 16:00,SPXW,Put,7/10/2019 0:00,3,2870,2570,27,-0.38,0.35,0.5,0,,,972,54,810000,0.0012,No,796660,797632,Yes,-0.0289,0.1495,2944.79,2938.79,17.24,17.72
7/10/2019 15:30,9/10/2019 16:00,SPXW,Put,9/10/2019 0:00,2,2860,2560,27,-0.51,0.45,0.65,0,,,1323,54,810000,0.001633333,No,797632,798955,Yes,-0.0309,0.2155,2947.4,2919.4,17.47,18.89
9/10/2019 15:30,11/10/2019 16:00,SPXW,Put,11/10/2019 0:00,2,2825,2525,27,-0.53,0.5,0.65,0,,,1377,54,810000,0.0017,No,798955,800332,Yes,-0.0282,0.2514,2926.81,2970.27,18.33,15.85
11/10/2019 15:30,14/10/2019 16:00,SPXW,Put,14/10/2019 0:00,3,2890,2590,27,-0.61,0.55,0.75,0,,,1593,54,810000,0.001966667,No,800332,801925,Yes,-0.0315,0.1998,2988.7,2966.15,15.61,14.8
14/10/2019 15:30,16/10/2019 16:00,SPXW,Put,16/10/2019 0:00,2,2885,2580,26,-0.43,0.4,0.55,0,,,1066,52,793000,0.001344262,No,801925,802991,Yes,-0.0287,0.203,2968.86,2989.69,14.9,13.74
16/10/2019 15:30,18/10/2019 16:00,SPXW,Put,18/10/2019 0:00,2,2900,2600,27,-0.48,0.45,0.6,0,,,1242,54,810000,0.001533333,No,802991,804233,Yes,-0.0293,0.2165,2989.01,2986.2,13.83,14.3
18/10/2019 15:30,21/10/2019 16:00,SPXW,Put,21/10/2019 0:00,3,2930,2630,27,-0.33,0.3,0.45,0,,,837,54,810000,0.001033333,No,804233,805070,Yes,-0.0305,0.123,2992.05,3006.72,14.21,14.1
21/10/2019 15:30,23/10/2019 16:00,SPXW,Put,23/10/2019 0:00,2,2940,2640,27,-0.28,0.25,0.4,0,,,702,54,810000,0.000866667,No,805070,805772,Yes,-0.0266,0.1533,3005.41,3004.52,14.16,14.09
23/10/2019 15:30,25/10/2019 16:00,SPXW,Put,25/10/2019 0:00,2,2930,2630,27,-0.33,0.3,0.45,0,,,837,54,810000,0.001033333,No,805772,806609,Yes,-0.028,0.1651,2998.96,3022.55,14.33,12.68
25/10/2019 15:30,28/10/2019 16:00,SPXW,Put,28/10/2019 0:00,3,2970,2670,27,-0.31,0.3,0.4,0,,,783,54,810000,0.000966667,No,806609,807392,Yes,-0.0327,0.1055,3022.47,3039.42,12.8,13.04
28/10/2019 15:30,30/10/2019 16:00,SPXW,Put,30/10/2019 0:00,2,2970,2670,27,-0.38,0.35,0.5,0,,,972,54,810000,0.0012,No,807392,808364,Yes,-0.0296,0.1719,3042.42,3046.77,12.98,12.43
30/10/2019 15:30,31/10/2019 16:00,SPXW,Put,31/10/2019 0:00,1,2995,2695,27,-0.28,0.25,0.4,0,,,702,54,810000,0.000866667,No,808364,809066,Yes,-0.0315,0.1744,3047.36,3037.56,12.5,13.32
31/10/2019 15:30,1/11/2019 16:00,SPXW,Put,1/11/2019 0:00,1,2970,2670,27,-0.33,0.3,0.45,0,,,837,54,810000,0.001033333,No,809066,809903,Yes,-0.0314,0.201,3029.85,3066.91,13.64,12.33
1/11/2019 15:30,4/11/2019 16:00,SPXW,Put,4/11/2019 0:00,3,3015,2715,27,-0.18,0.15,0.3,0,,,432,54,810000,0.000533333,No,809903,810335,Yes,-0.0264,0.0889,3062.36,3078.27,12.32,12.79
4/11/2019 15:30,6/11/2019 16:00,SPXW,Put,6/11/2019 0:00,2,3015,2715,27,-0.31,0.3,0.4,0,,,783,54,810000,0.000966667,No,810335,811118,Yes,-0.0296,0.142,3075.64,3076.78,12.75,12.71
6/11/2019 15:30,8/11/2019 16:00,SPXW,Put,8/11/2019 0:00,2,3020,2720,27,-0.33,0.3,0.45,0,,,837,54,810000,0.001033333,No,811118,811955,Yes,-0.0339,0.1299,3075.27,3093.08,12.89,12.13
8/11/2019 15:30,11/11/2019 16:00,SPXW,Put,11/11/2019 0:00,3,3045,2745,27,-0.23,0.2,0.35,0,,,567,54,810000,0.0007,No,811955,812522,Yes,-0.0322,0.0844,3088.51,3087.01,12.12,12.82
11/11/2019 15:30,13/11/2019 16:00,SPXW,Put,13/11/2019 0:00,2,3030,2730,27,-0.23,0.2,0.35,0,,,567,54,810000,0.0007,No,812522,813089,Yes,-0.0266,0.128,3086.54,3094.04,12.76,13.08
13/11/2019 15:30,15/11/2019 16:00,SPXW,Put,15/11/2019 0:00,2,3015,2715,27,-0.43,0.4,0.55,0,,,1107,54,810000,0.001366667,No,813089,814196,Yes,-0.03,0.185,3094.94,3120.46,13.05,11.95
15/11/2019 15:30,18/11/2019 16:00,SPXW,Put,18/11/2019 0:00,3,3060,2760,27,-0.23,0.2,0.35,0,,,567,54,810000,0.0007,No,814196,814763,Yes,-0.0275,0.1,3113.89,3122.03,12.18,12.5
18/11/2019 15:30,20/11/2019 16:00,SPXW,Put,20/11/2019 0:00,2,3055,2755,27,-0.33,0.3,0.45,0,,,837,54,810000,0.001033333,No,814763,815600,Yes,-0.0294,0.1503,3120.88,3108.46,12.55,12.9
20/11/2019 15:30,22/11/2019 16:00,SPXW,Put,22/11/2019 0:00,2,3010,2710,27,-0.51,0.45,0.65,0,,,1323,54,810000,0.001633333,No,815600,816923,Yes,-0.0294,0.2172,3103.72,3110.29,13.09,12.45
22/11/2019 15:30,25/11/2019 16:00,SPXW,Put,25/11/2019 0:00,3,3060,2760,27,-0.23,0.2,0.35,0,,,567,54,810000,0.0007,No,816923,817490,Yes,-0.0291,0.094,3110.17,3133.64,12.51,11.88
25/11/2019 15:30,27/11/2019 16:00,SPXW,Put,27/11/2019 0:00,2,3075,2775,27,-0.33,0.3,0.45,0,,,837,54,810000,0.001033333,No,817490,818327,Yes,-0.0322,0.1352,3132.48,3153.63,11.74,11.72
27/11/2019 15:30,29/11/2019 16:00,SPXW,Put,29/11/2019 0:00,2,3110,2810,27,-0.21,0.2,0.3,0,,,513,54,810000,0.000633333,No,818327,818840,Yes,-0.0304,0.0984,3153.5,3140.98,11.53,12.62
29/11/2019 15:30,2/12/2019 16:00,SPXW,Put,2/12/2019 0:00,3,3070,2770,27,-0.34,0.25,0.5,0,,,864,54,810000,0.001066667,No,818840,819704,Yes,-0.0281,0.1369,3140.98,3113.87,12.62,14.7
2/12/2019 15:30,4/12/2019 16:00,SPXW,Put,4/12/2019 0:00,2,3020,2720,27,-0.53,0.5,0.65,0,,,1377,54,810000,0.0017,No,819704,821081,Yes,-0.0296,0.2237,3116.64,3112.76,14.58,14.77
4/12/2019 15:30,6/12/2019 16:00,SPXW,Put,6/12/2019 0:00,2,3025,2725,27,-0.48,0.45,0.6,0,,,1242,54,810000,0.001533333,No,821081,822323,Yes,-0.0292,0.2084,3115.41,3145.91,14.61,13.6
6/12/2019 15:30,9/12/2019 16:00,SPXW,Put,9/12/2019 0:00,3,3080,2780,27,-0.31,0.25,0.45,0,,,783,54,810000,0.000966667,No,822323,823106,Yes,-0.0288,0.1248,3147.14,3135.96,13.59,15.81
9/12/2019 15:30,11/12/2019 16:00,SPXW,Put,11/12/2019 0:00,2,3045,2740,27,-0.43,0.4,0.55,0,,,1107,54,823500,0.001344262,No,823106,824213,Yes,-0.0296,0.222,3141.1,3141.63,15.32,15.07
11/12/2019 15:30,13/12/2019 16:00,SPXW,Put,13/12/2019 0:00,2,3050,2750,27,-0.43,0.4,0.55,0,,,1107,54,810000,0.001366667,No,824213,825320,Yes,-0.029,0.2082,3141.09,3168.8,15.25,12.68
13/12/2019 15:30,16/12/2019 16:00,SPXW,Put,16/12/2019 0:00,3,3065,2760,27,-0.56,0.5,0.7,0,,,1458,54,823500,0.001770492,No,825320,826778,Yes,-0.0298,0.1937,3167.88,3191.45,12.65,12.36
16/12/2019 15:30,18/12/2019 16:00,SPXW,Put,18/12/2019 0:00,2,3105,2800,27,-0.48,0.45,0.6,0,,,1242,54,823500,0.001508197,No,826778,828020,Yes,-0.0316,0.2027,3193.02,3191.14,12.18,12.68
18/12/2019 15:30,20/12/2019 16:00,SPXW,Put,20/12/2019 0:00,2,3120,2820,28,-0.36,0.3,0.5,0,,,952,56,840000,0.001133333,No,828020,828972,Yes,-0.031,0.1726,3195.29,3221.22,12.44,12.49
20/12/2019 15:30,23/12/2019 16:00,SPXW,Put,23/12/2019 0:00,3,3175,2875,28,-0.23,0.2,0.35,0,,,588,56,840000,0.0007,No,828972,829560,Yes,-0.0299,0.0879,3222.89,3224.01,12.5,12.78
23/12/2019 15:30,24/12/2019 16:00,SPXW,Put,24/12/2019 0:00,1,3190,2890,28,-0.13,0.1,0.25,0,,,308,56,840000,0.000366667,No,829560,829868,Yes,-0.028,0.1078,3225.3,3223.38,12.7,12.67
24/12/2019 15:30,27/12/2019 16:00,SPXW,Put,27/12/2019 0:00,3,3165,2865,28,-0.28,0.25,0.4,0,,,728,56,840000,0.000866667,No,829868,830596,Yes,-0.0286,0.1077,3223.38,3240.02,12.67,13.38
27/12/2019 15:30,30/12/2019 16:00,SPXW,Put,30/12/2019 0:00,3,3185,2885,28,-0.26,0.25,0.35,0,,,672,56,840000,0.0008,No,830596,831268,Yes,-0.0281,0.1017,3241.18,3221.29,13.35,14.87
30/12/2019 15:30,31/12/2019 16:00,SPXW,Put,31/12/2019 0:00,1,3160,2860,28,-0.33,0.3,0.45,0,,,868,56,840000,0.001033333,No,831268,832136,Yes,-0.0299,0.2,3224.12,3230.78,14.68,13.92
2/1/2020 9:31,3/1/2020 16:00,SPXW,Put,3/1/2020 0:00,1,3180,2880,28,-0.41,0.4,0.5,0,,,1092,56,840000,0.0013,No,832136,833228,Yes,-0.0326,0.192,3247.22,3234.85,13.55,14.1
3/1/2020 15:30,6/1/2020 16:00,SPXW,Put,6/1/2020 0:00,3,3160,2860,28,-0.43,0.4,0.55,0,,,1148,56,840000,0.001366667,No,833228,834376,Yes,-0.0303,0.1433,3238.32,3246.28,13.9,13.69
6/1/2020 15:30,8/1/2020 16:00,SPXW,Put,8/1/2020 0:00,2,3165,2865,28,-0.36,0.3,0.5,0,,,952,56,840000,0.001133333,No,834376,835328,Yes,-0.0289,0.1662,3240.54,3253.05,14.01,13.84
8/1/2020 15:30,10/1/2020 16:00,SPXW,Put,10/1/2020 0:00,2,3170,2870,28,-0.51,0.45,0.65,0,,,1372,56,840000,0.001633333,No,835328,836700,Yes,-0.0296,0.2132,3266.52,3265.35,12.86,12.54
10/1/2020 15:30,13/1/2020 16:00,SPXW,Put,13/1/2020 0:00,3,3200,2900,28,-0.33,0.3,0.45,0,,,868,56,840000,0.001033333,No,836700,837568,Yes,-0.0287,0.1209,3267.76,3288.13,12.49,12.35
13/1/2020 15:30,15/1/2020 16:00,SPXW,Put,15/1/2020 0:00,2,3210,2910,28,-0.38,0.35,0.5,0,,,1008,56,840000,0.0012,No,837568,838576,Yes,-0.0297,0.1588,3282.33,3289.29,12.53,12.54
15/1/2020 15:30,17/1/2020 16:00,SPXW,Put,17/1/2020 0:00,2,3200,2900,28,-0.46,0.4,0.6,0,,,1232,56,840000,0.001466667,No,838576,839808,Yes,-0.0304,0.1889,3284.65,3329.62,12.64,12.07
17/1/2020 15:30,21/1/2020 16:00,SPXW,Put,21/1/2020 0:00,4,3270,2970,28,-0.28,0.25,0.4,0,,,728,56,840000,0.000866667,No,839808,840536,Yes,-0.0305,0.0842,3324.27,3320.79,12.2,12.86
21/1/2020 15:30,22/1/2020 16:00,SPXW,Put,22/1/2020 0:00,1,3270,2970,28,-0.28,0.25,0.4,0,,,728,56,840000,0.000866667,No,840536,841264,Yes,-0.0307,0.1646,3323.99,3321.75,12.74,12.75
22/1/2020 15:30,24/1/2020 16:00,SPXW,Put,24/1/2020 0:00,2,3250,2950,28,-0.43,0.4,0.55,0,,,1148,56,840000,0.001366667,No,841264,842412,Yes,-0.0322,0.1592,3321.71,3295.47,12.9,14.7
24/1/2020 15:30,27/1/2020 16:00,SPXW,Put,27/1/2020 0:00,3,3185,2880,28,-0.59,0.5,0.75,0,,,1596,56,854000,0.001868852,No,842412,844008,Yes,-0.0288,0.2007,3297.32,3243.63,14.64,17.94
27/1/2020 15:30,29/1/2020 16:00,SPXW,Put,29/1/2020 0:00,2,3085,2780,28,-0.84,0.75,1,0,,,2296,56,854000,0.002688525,No,844008,846304,Yes,-0.0291,0.3715,3250.41,3273.4,17.5,16.42
29/1/2020 15:30,31/1/2020 16:00,SPXW,Put,31/1/2020 0:00,2,3170,2870,28,-0.59,0.5,0.75,0,,,1596,56,840000,0.0019,No,846304,847900,Yes,-0.0288,0.2461,3282.24,3225.52,15.81,19
31/1/2020 15:30,3/2/2020 16:00,SPXW,Put,3/2/2020 0:00,3,3060,2750,27,-0.96,0.9,1.1,0,,,2538,54,837000,0.003032258,No,847900,850438,Yes,-0.0306,0.3044,3221.98,3248.92,19.37,17.92
3/2/2020 15:30,5/2/2020 16:00,SPXW,Put,5/2/2020 0:00,2,3125,2825,28,-0.71,0.7,0.8,0,,,1932,56,840000,0.0023,No,850438,852370,Yes,-0.0295,0.2944,3256.33,3334.69,17.71,15.19
5/2/2020 15:30,7/2/2020 16:00,SPXW,Put,7/2/2020 0:00,2,3235,2935,28,-0.51,0.45,0.65,0,,,1372,56,840000,0.001633333,No,852370,853742,Yes,-0.0289,0.2145,3334.97,3327.71,15.14,15.52
7/2/2020 15:30,10/2/2020 16:00,SPXW,Put,10/2/2020 0:00,3,3240,2940,28,-0.53,0.5,0.65,0,,,1428,56,840000,0.0017,No,853742,855170,Yes,-0.0318,0.1585,3328.11,3352.09,15.6,15.15
10/2/2020 15:30,12/2/2020 16:00,SPXW,Put,12/2/2020 0:00,2,3260,2960,29,-0.43,0.4,0.55,0,,,1189,58,870000,0.001366667,No,855170,856359,Yes,-0.0281,0.1846,3346.76,3379.45,15.26,13.87
12/2/2020 15:30,14/2/2020 16:00,SPXW,Put,14/2/2020 0:00,2,3300,3000,29,-0.38,0.35,0.5,0,,,1044,58,870000,0.0012,No,856359,857403,Yes,-0.0286,0.1615,3377.23,3380.16,13.82,13.81
14/2/2020 15:30,18/2/2020 16:00,SPXW,Put,18/2/2020 0:00,4,3290,2990,29,-0.51,0.5,0.6,0,,,1421,58,870000,0.001633333,No,857403,858824,Yes,-0.0324,0.1272,3372,3370.29,14.2,14.76
18/2/2020 15:30,19/2/2020 16:00,SPXW,Put,19/2/2020 0:00,1,3305,3005,29,-0.36,0.3,0.5,0,,,986,58,870000,0.001133333,No,858824,859810,Yes,-0.0304,0.1994,3372.13,3386.15,14.75,14.47
19/2/2020 15:30,21/2/2020 16:00,SPXW,Put,21/2/2020 0:00,2,3300,3000,29,-0.43,0.4,0.55,0,,,1189,58,870000,0.001366667,No,859810,860999,Yes,-0.0294,0.1902,3389.37,3337.75,14.54,17.37
21/2/2020 15:30,24/2/2020 16:00,SPXW,Put,24/2/2020 0:00,3,3230,2930,29,-0.54,0.45,0.7,4.11,,,-10411,58,870000,-0.011966667,Yes,860999,850588,Yes,-0.0292,0.1811,3332.67,3225.89,17.79,24.84
24/2/2020 15:30,26/2/2020 16:00,SPXW,Put,26/2/2020 0:00,2,2930,2625,28,-1.56,1.45,1.75,0,,,4312,56,854000,0.00504918,No,850588,854900,Yes,-0.029,0.7247,3242.38,3116.39,23.81,27.18
26/2/2020 15:30,28/2/2020 16:00,SPXW,Put,28/2/2020 0:00,2,2860,2550,28,-1.31,1.2,1.5,0,,,3612,56,868000,0.00416129,No,854900,858512,Yes,-0.0301,0.6315,3122.76,2954.22,28.18,42.62
28/2/2020 15:30,2/3/2020 16:00,SPXW,Put,2/3/2020 0:00,3,2450,2150,29,-2.59,2.15,3.1,0,,,7453,58,870000,0.008566667,No,858512,865965,Yes,-0.0302,0.9824,2889.92,3090.23,47.17,31.71
2/3/2020 15:30,4/3/2020 16:00,SPXW,Put,4/3/2020 0:00,2,2750,2450,29,-1.74,1.55,2,0,,,4988,58,870000,0.005733333,No,865965,870953,Yes,-0.0303,0.7085,3033.37,3130.12,34.42,31.32
4/3/2020 15:30,6/3/2020 16:00,SPXW,Put,6/3/2020 0:00,2,2855,2555,29,-1.56,1.45,1.75,0,,,4466,58,870000,0.005133333,No,870953,875419,Yes,-0.0294,0.6151,3110.53,2972.37,31.42,41.8
6/3/2020 15:30,9/3/2020 16:00,SPXW,Put,9/3/2020 0:00,3,2590,2300,30,-1.89,1.6,2.25,0,,,5610,60,870000,0.006448276,No,875419,881029,Yes,-0.0302,0.7118,2920.96,2746.56,48.49,55.07
9/3/2020 15:30,11/3/2020 16:00,SPXW,Put,11/3/2020 0:00,2,2350,2050,29,-1.76,1.55,2.05,0,,,5046,58,870000,0.0058,No,881029,886075,Yes,-0.026,1.1712,2777.11,2741.38,53.73,53.95
11/3/2020 15:30,13/3/2020 16:00,SPXW,Put,13/3/2020 0:00,2,2350,2050,30,-2.59,2.35,2.9,0,,,7710,60,900000,0.008566667,No,886075,893785,Yes,-0.0345,1.1115,2727.72,2711.02,54.77,57.17
13/3/2020 15:30,16/3/2020 16:00,SPXW,Put,16/3/2020 0:00,3,2150,1850,30,-3.81,2.85,4.85,0,,,11370,60,900000,0.012633333,No,893785,905155,Yes,-0.0353,1.1514,2586.39,2386.13,62.82,83.05
17/3/2020 9:31,18/3/2020 16:00,SPXW,Put,18/3/2020 0:00,1,1950,1650,30,-3.78,3.2,4.45,0,,,11280,60,900000,0.012533333,No,905155,916435,Yes,-0.0311,2.1352,2447.28,2398.1,82.66,75.99
18/3/2020 15:30,20/3/2020 16:00,SPXW,Put,20/3/2020 0:00,2,1850,1550,31,-3.56,2.85,4.35,0,,,10974,62,930000,0.0118,No,916435,927409,Yes,-0.0331,1.6813,2315.56,2304.92,79.69,66.92
20/3/2020 15:30,23/3/2020 16:00,SPXW,Put,23/3/2020 0:00,3,2000,1700,31,-3.33,3,3.75,0,,,10261,62,930000,0.011033333,No,927409,937670,Yes,-0.0385,1.008,2343.26,2237.4,64.34,60.8
24/3/2020 9:31,25/3/2020 16:00,SPXW,Put,25/3/2020 0:00,1,2060,1750,30,-1.81,1.2,2.5,0,,,5370,60,930000,0.005774194,No,937670,943040,Yes,-0.03,1.212,2355.14,2475.56,57.81,65.25
25/3/2020 15:30,27/3/2020 16:00,SPXW,Put,27/3/2020 0:00,2,2160,1860,31,-2.44,2.2,2.75,0,,,7502,62,930000,0.008066667,No,943040,950542,Yes,-0.0292,1.1845,2544.16,2541.47,61.72,64.91
27/3/2020 15:30,30/3/2020 16:00,SPXW,Put,30/3/2020 0:00,3,2335,2035,32,-1.66,1.55,1.85,0,,,5248,64,960000,0.005466667,No,950542,955790,Yes,-0.0293,0.6463,2607.07,2626.65,62.17,56.86
30/3/2020 15:30,31/3/2020 16:00,SPXW,Put,31/3/2020 0:00,1,2380,2080,32,-1.34,1.2,1.55,0,,,4224,64,960000,0.0044,No,955790,960014,Yes,-0.0294,0.916,2607.62,2584.59,58.09,53.65
31/3/2020 15:30,1/4/2020 16:00,SPXW,Put,1/4/2020 0:00,1,2330,2030,32,-1.51,1.35,1.75,0,,,4768,64,960000,0.004966667,No,960014,964782,Yes,-0.0298,1.0055,2575.62,2470.5,54.88,56.45
1/4/2020 15:30,3/4/2020 16:00,SPXW,Put,3/4/2020 0:00,2,2185,1880,32,-1.81,1.65,2.05,0,,,5728,64,976000,0.005868852,No,964782,970510,Yes,-0.0309,0.8525,2458.14,2488.65,58.19,47.28
6/4/2020 9:31,8/4/2020 16:00,SPXW,Put,8/4/2020 0:00,2,2350,2050,32,-1.49,1.2,1.85,0,,,4704,64,960000,0.0049,No,970510,975214,Yes,-0.0309,0.6487,2585.05,2749.98,45.51,43.43
9/4/2020 9:31,13/4/2020 16:00,SPXW,Put,13/4/2020 0:00,4,2530,2230,33,-1.49,1.15,1.9,0,,,4851,66,990000,0.0049,No,975214,980065,Yes,-0.0296,0.4629,2780.51,2761.63,43.1,41.48
13/4/2020 15:30,15/4/2020 16:00,SPXW,Put,15/4/2020 0:00,2,2560,2260,33,-1.16,1.05,1.35,0,,,3762,66,990000,0.0038,No,980065,983827,Yes,-0.0296,0.5234,2755.11,2783.36,42.45,40.92
15/4/2020 15:30,17/4/2020 16:00,SPXW,Put,17/4/2020 0:00,2,2595,2295,33,-1.08,1,1.25,0,,,3498,66,990000,0.003533333,No,983827,987325,Yes,-0.0291,0.5067,2786.56,2874.56,40.83,38.11
17/4/2020 15:30,20/4/2020 16:00,SPXW,Put,20/4/2020 0:00,3,2700,2395,32,-0.91,0.8,1.1,0,,,2848,64,976000,0.002918033,No,987325,990173,Yes,-0.0304,0.3227,2852.64,2823.16,38.43,43.11
20/4/2020 15:30,22/4/2020 16:00,SPXW,Put,22/4/2020 0:00,2,2630,2330,33,-1.26,1.15,1.45,0,,,4092,66,990000,0.004133333,No,990173,994265,Yes,-0.0306,0.5295,2830.5,2799.31,42.93,41.9
22/4/2020 15:30,24/4/2020 16:00,SPXW,Put,24/4/2020 0:00,2,2630,2330,33,-1.06,0.95,1.25,0,,,3432,66,990000,0.003466667,No,994265,997697,Yes,-0.0301,0.464,2806.29,2836.74,41.8,35.83
24/4/2020 15:30,27/4/2020 16:00,SPXW,Put,27/4/2020 0:00,3,2710,2410,33,-0.76,0.65,0.95,0,,,2442,66,990000,0.002466667,No,997697,1000139,Yes,-0.0312,0.2676,2835.14,2878.48,36.15,33.1
27/4/2020 15:30,29/4/2020 16:00,SPXW,Put,29/4/2020 0:00,2,2740,2440,33,-0.81,0.7,1,0,,,2607,66,990000,0.002633333,No,1000139,1002746,Yes,-0.0298,0.3589,2881.07,2939.51,33.16,31.53
29/4/2020 15:30,30/4/2020 16:00,SPXW,Put,30/4/2020 0:00,1,2845,2545,33,-0.66,0.6,0.8,0,,,2112,66,990000,0.002133333,No,1002746,1004858,Yes,-0.031,0.3787,2953.18,2912.43,31.36,33.97
30/4/2020 15:30,1/5/2020 16:00,SPXW,Put,1/5/2020 0:00,1,2800,2500,33,-0.66,0.6,0.8,0,,,2112,66,990000,0.002133333,No,1004858,1006970,Yes,-0.0305,0.3912,2911.73,2830.71,34.01,37.2
1/5/2020 15:30,4/5/2020 16:00,SPXW,Put,4/5/2020 0:00,3,2700,2395,33,-0.84,0.75,1,0,,,2706,66,1006500,0.002688525,No,1006970,1009676,Yes,-0.0319,0.2849,2833.14,2842.74,38.03,35.73
4/5/2020 15:30,6/5/2020 16:00,SPXW,Put,6/5/2020 0:00,2,2685,2380,33,-0.84,0.75,1,0,,,2706,66,1006500,0.002688525,No,1009676,1012382,Yes,-0.0286,0.3924,2838.89,2848.42,36.21,33.8
6/5/2020 15:30,8/5/2020 16:00,SPXW,Put,8/5/2020 0:00,2,2710,2410,34,-0.86,0.8,1,0,,,2856,68,1020000,0.0028,No,1012382,1015238,Yes,-0.03,0.3981,2867.07,2929.8,32.7,28.31
8/5/2020 15:30,11/5/2020 16:00,SPXW,Put,11/5/2020 0:00,3,2805,2500,33,-0.66,0.6,0.8,0,,,2112,66,1006500,0.002098361,No,1015238,1017350,Yes,-0.0298,0.2422,2923.6,2930.19,28.66,27.54
11/5/2020 15:30,13/5/2020 16:00,SPXW,Put,13/5/2020 0:00,2,2805,2500,33,-0.76,0.7,0.9,0,,,2442,66,1006500,0.00242623,No,1017350,1019792,Yes,-0.0307,0.3316,2938.26,2820,27.2,34.94
13/5/2020 15:30,15/5/2020 16:00,SPXW,Put,15/5/2020 0:00,2,2600,2300,34,-1.09,1,1.25,0,,,3638,68,1020000,0.003566667,No,1019792,1023430,Yes,-0.0293,0.5308,2801.61,2863.7,36.72,31.1
18/5/2020 9:31,20/5/2020 16:00,SPXW,Put,20/5/2020 0:00,2,2770,2470,34,-0.94,0.85,1.1,0,,,3128,68,1020000,0.003066667,No,1023430,1026558,Yes,-0.0293,0.3857,2934.28,2971.61,30.24,27.97
20/5/2020 15:30,22/5/2020 16:00,SPXW,Put,22/5/2020 0:00,2,2840,2540,34,-0.81,0.75,0.95,0,,,2686,68,1020000,0.002633333,No,1026558,1029244,Yes,-0.0313,0.3291,2972.76,2955.45,28.23,28.12
26/5/2020 9:31,27/5/2020 16:00,SPXW,Put,27/5/2020 0:00,1,2915,2610,34,-0.63,0.6,0.75,0,,,2074,68,1037000,0.002,No,1029244,1031318,Yes,-0.031,0.3207,3020.32,3036.13,27.86,27.55
27/5/2020 15:30,29/5/2020 16:00,SPXW,Put,29/5/2020 0:00,2,2880,2580,34,-0.81,0.75,0.95,0,,,2686,68,1020000,0.002633333,No,1031318,1034004,Yes,-0.03,0.3397,3021.3,3044.31,27.77,27.53
29/5/2020 15:30,1/6/2020 16:00,SPXW,Put,1/6/2020 0:00,3,2905,2600,34,-0.81,0.7,1,0,,,2686,68,1037000,0.002590164,No,1034004,1036690,Yes,-0.0314,0.2628,3036.99,3055.73,28.37,28.27
1/6/2020 15:30,3/6/2020 16:00,SPXW,Put,3/6/2020 0:00,2,2925,2625,35,-0.78,0.75,0.9,0,,,2660,70,1050000,0.002533333,No,1036690,1039350,Yes,-0.0312,0.321,3058.46,3122.87,28.19,25.44
3/6/2020 15:30,5/6/2020 16:00,SPXW,Put,5/6/2020 0:00,2,2995,2695,35,-0.73,0.7,0.85,0,,,2485,70,1050000,0.002366667,No,1039350,1041835,Yes,-0.0305,0.3052,3125.89,3193.93,25.22,23.98
5/6/2020 15:30,8/6/2020 16:00,SPXW,Put,8/6/2020 0:00,3,3090,2790,35,-0.66,0.6,0.8,0,,,2240,70,1050000,0.002133333,No,1041835,1044075,Yes,-0.0307,0.2065,3199.84,3232.39,24.34,25.69
8/6/2020 15:30,10/6/2020 16:00,SPXW,Put,10/6/2020 0:00,2,3085,2785,35,-0.71,0.65,0.85,0,,,2415,70,1050000,0.0023,No,1044075,1046490,Yes,-0.03,0.3017,3217.97,3190.14,25.65,27.28
10/6/2020 15:30,12/6/2020 16:00,SPXW,Put,12/6/2020 0:00,2,3065,2765,35,-0.78,0.7,0.95,23.69,,,-80255,70,1050000,-0.076433333,Yes,1046490,966235,Yes,-0.0291,0.3316,3212.62,3041.31,26.46,35.89
12/6/2020 15:30,15/6/2020 16:00,SPXW,Put,15/6/2020 0:00,3,2730,2425,32,-1.64,1.5,1.85,0,,,5184,64,976000,0.005311475,No,966235,971419,Yes,-0.0296,0.5838,3014.77,3066.59,39.3,34.99
15/6/2020 15:30,17/6/2020 16:00,SPXW,Put,17/6/2020 0:00,2,2840,2550,33,-1.21,1.15,1.35,0,,,3927,66,957000,0.004103448,No,971419,975346,Yes,-0.0301,0.528,3056.91,3113.49,35.55,33.76
17/6/2020 15:30,19/6/2020 16:00,SPXW,Put,19/6/2020 0:00,2,2925,2625,33,-1.04,0.95,1.2,0,,,3366,66,990000,0.0034,No,975346,978712,Yes,-0.0306,0.4545,3116.28,3097.74,34.05,32.91
19/6/2020 15:30,22/6/2020 16:00,SPXW,Put,22/6/2020 0:00,3,2940,2640,33,-0.96,0.85,1.15,0,,,3102,66,990000,0.003133333,No,978712,981814,Yes,-0.029,0.3271,3109.91,3117.86,32.42,31.9
22/6/2020 15:30,24/6/2020 16:00,SPXW,Put,24/6/2020 0:00,2,2935,2630,32,-1.01,0.9,1.2,0,,,3168,64,976000,0.003245902,No,981814,984982,Yes,-0.0302,0.4095,3107.49,3050.33,33.02,34.56
24/6/2020 15:30,26/6/2020 16:00,SPXW,Put,26/6/2020 0:00,2,2870,2570,33,-1.16,1.05,1.35,0,,,3762,66,990000,0.0038,No,984982,988744,Yes,-0.0311,0.4559,3057.25,3009.05,34.46,35.13
26/6/2020 15:30,29/6/2020 16:00,SPXW,Put,29/6/2020 0:00,3,2850,2550,33,-0.86,0.8,1,0,,,2772,66,990000,0.0028,No,988744,991516,Yes,-0.0293,0.3255,3013.86,3053.24,35.74,32.39
29/6/2020 15:30,30/6/2020 16:00,SPXW,Put,30/6/2020 0:00,1,2920,2620,33,-0.63,0.6,0.75,0,,,2013,66,990000,0.002033333,No,991516,993529,Yes,-0.0284,0.3914,3038.15,3100.29,33.26,29.92
30/6/2020 15:30,1/7/2020 16:00,SPXW,Put,1/7/2020 0:00,1,2975,2675,33,-0.63,0.6,0.75,0,,,2013,66,990000,0.002033333,No,993529,995542,Yes,-0.0312,0.3722,3086.81,3115.86,29.92,28.64
1/7/2020 15:30,2/7/2020 16:00,SPXW,Put,2/7/2020 0:00,1,2995,2695,33,-0.69,0.6,0.85,0,,,2211,66,990000,0.002233333,No,995542,997753,Yes,-0.0286,0.4183,3125,3130.01,28.78,27.84
2/7/2020 15:30,6/7/2020 16:00,SPXW,Put,6/7/2020 0:00,4,3010,2710,33,-0.74,0.65,0.9,0,,,2376,66,990000,0.0024,No,997753,1000129,Yes,-0.0294,0.2181,3142.25,3179.72,27.2,27.89
6/7/2020 15:30,8/7/2020 16:00,SPXW,Put,8/7/2020 0:00,2,3045,2740,33,-0.76,0.7,0.9,0,,,2442,66,1006500,0.00242623,No,1000129,1002571,Yes,-0.0311,0.2938,3171.43,3169.94,28.07,28.12
8/7/2020 15:30,10/7/2020 16:00,SPXW,Put,10/7/2020 0:00,2,3030,2730,33,-0.76,0.7,0.9,0,,,2442,66,990000,0.002466667,No,1002571,1005013,Yes,-0.0298,0.3088,3165.04,3185.04,28.35,27.36
10/7/2020 15:30,13/7/2020 16:00,SPXW,Put,13/7/2020 0:00,3,3075,2775,34,-0.61,0.55,0.75,0,,,2006,68,1020000,0.001966667,No,1005013,1007019,Yes,-0.0306,0.2012,3181.81,3155.22,27.44,31.94
13/7/2020 15:30,15/7/2020 16:00,SPXW,Put,15/7/2020 0:00,2,3005,2700,33,-0.98,0.95,1.1,0,,,3168,66,1006500,0.003147541,No,1007019,1010187,Yes,-0.0295,0.4021,3179.93,3226.56,30.74,27.86
15/7/2020 15:30,17/7/2020 16:00,SPXW,Put,17/7/2020 0:00,2,3065,2765,34,-1.01,0.95,1.15,0,,,3366,68,1020000,0.0033,No,1010187,1013553,Yes,-0.0316,0.3665,3223.67,3224.73,28.22,25.63
17/7/2020 15:30,20/7/2020 16:00,SPXW,Put,20/7/2020 0:00,3,3120,2820,34,-0.58,0.55,0.7,0,,,1904,68,1020000,0.001866667,No,1013553,1015457,Yes,-0.0299,0.204,3230.67,3251.84,25.75,24.58
20/7/2020 15:30,22/7/2020 16:00,SPXW,Put,22/7/2020 0:00,2,3135,2830,33,-0.61,0.55,0.75,0,,,1947,66,1006500,0.001934426,No,1015457,1017404,Yes,-0.0285,0.2606,3253.23,3276.02,24.6,24.13
22/7/2020 15:30,24/7/2020 16:00,SPXW,Put,24/7/2020 0:00,2,3145,2845,34,-0.74,0.65,0.9,0,,,2448,68,1020000,0.0024,No,1017404,1019852,Yes,-0.0312,0.2763,3268.01,3215.63,24.52,25.66
24/7/2020 15:30,27/7/2020 16:00,SPXW,Put,27/7/2020 0:00,3,3105,2800,33,-0.61,0.55,0.75,0,,,1947,66,1006500,0.001934426,No,1019852,1021799,Yes,-0.0305,0.1932,3209.09,3239.41,26.39,24.79
27/7/2020 15:30,29/7/2020 16:00,SPXW,Put,29/7/2020 0:00,2,3125,2825,34,-0.64,0.55,0.8,0,,,2108,68,1020000,0.002066667,No,1021799,1023907,Yes,-0.0299,0.2565,3239.72,3258.44,24.99,24.05
29/7/2020 15:30,31/7/2020 16:00,SPXW,Put,31/7/2020 0:00,2,3115,2815,34,-0.76,0.7,0.9,0,,,2516,68,1020000,0.002466667,No,1023907,1026423,Yes,-0.0295,0.3212,3259.79,3271.12,24.04,23.85
31/7/2020 15:30,3/8/2020 16:00,SPXW,Put,3/8/2020 0:00,3,3150,2850,34,-0.63,0.6,0.75,0,,,2074,68,1020000,0.002033333,No,1026423,1028497,Yes,-0.0316,0.1901,3252.97,3294.61,24.21,24.47
3/8/2020 15:30,5/8/2020 16:00,SPXW,Put,5/8/2020 0:00,2,3170,2870,34,-0.68,0.65,0.8,0,,,2244,68,1020000,0.0022,No,1028497,1030741,Yes,-0.0298,0.2791,3296.17,3327.77,24.55,22.98
5/8/2020 15:30,7/8/2020 16:00,SPXW,Put,7/8/2020 0:00,2,3210,2910,34,-0.64,0.6,0.75,0,,,2108,68,1020000,0.002066667,No,1030741,1032849,Yes,-0.0301,0.2485,3324.76,3351.28,23.11,22.24
7/8/2020 15:30,10/8/2020 16:00,SPXW,Put,10/8/2020 0:00,3,3220,2920,34,-0.66,0.6,0.8,0,,,2176,68,1020000,0.002133333,No,1032849,1035025,Yes,-0.0298,0.2123,3338.77,3360.47,22.63,22.01
10/8/2020 15:30,12/8/2020 16:00,SPXW,Put,12/8/2020 0:00,2,3245,2940,34,-0.61,0.55,0.75,0,,,2006,68,1037000,0.001934426,No,1035025,1037031,Yes,-0.0294,0.244,3358.6,3380.35,22.14,22.08
12/8/2020 15:30,14/8/2020 16:00,SPXW,Put,14/8/2020 0:00,2,3260,2960,35,-0.71,0.65,0.85,0,,,2415,70,1050000,0.0023,No,1037031,1039446,Yes,-0.0301,0.2691,3385.77,3372.85,22.1,21.82
14/8/2020 15:30,17/8/2020 16:00,SPXW,Put,17/8/2020 0:00,3,3260,2960,35,-0.59,0.55,0.7,0,,,1995,70,1050000,0.0019,No,1039446,1041441,Yes,-0.0302,0.1865,3365.81,3381.99,22.4,21.56
17/8/2020 15:30,19/8/2020 16:00,SPXW,Put,19/8/2020 0:00,2,3275,2975,35,-0.58,0.55,0.7,0,,,1960,70,1050000,0.001866667,No,1041441,1043401,Yes,-0.0306,0.2315,3383.43,3374.85,21.75,22.54
19/8/2020 15:30,21/8/2020 16:00,SPXW,Put,21/8/2020 0:00,2,3235,2935,35,-0.74,0.65,0.9,0,,,2520,70,1050000,0.0024,No,1043401,1045921,Yes,-0.0296,0.3166,3382.23,3397.16,22.42,22.18
21/8/2020 15:30,24/8/2020 16:00,SPXW,Put,24/8/2020 0:00,3,3280,2980,35,-0.63,0.6,0.75,0,,,2135,70,1050000,0.002033333,No,1045921,1048056,Yes,-0.0301,0.206,3398.08,3431.28,22.4,22.34
24/8/2020 15:30,26/8/2020 16:00,SPXW,Put,26/8/2020 0:00,2,3305,3000,34,-0.61,0.55,0.75,0,,,2006,68,1037000,0.001934426,No,1048056,1050062,Yes,-0.0302,0.2485,3421.89,3478.73,22.58,23.15
26/8/2020 15:30,28/8/2020 16:00,SPXW,Put,28/8/2020 0:00,2,3320,3020,35,-0.83,0.8,0.95,0,,,2835,70,1050000,0.0027,No,1050062,1052897,Yes,-0.0305,0.3374,3479.95,3508.01,22.85,22.68
28/8/2020 15:30,31/8/2020 16:00,SPXW,Put,31/8/2020 0:00,3,3390,3090,35,-0.61,0.55,0.75,0,,,2065,70,1050000,0.001966667,No,1052897,1054962,Yes,-0.0289,0.195,3506.05,3500.31,22.84,26.13
31/8/2020 15:30,2/9/2020 16:00,SPXW,Put,2/9/2020 0:00,2,3370,3070,35,-0.73,0.7,0.85,0,,,2485,70,1050000,0.002366667,No,1054962,1057447,Yes,-0.0308,0.285,3506.66,3580.84,25.82,26.6
2/9/2020 15:30,4/9/2020 16:00,SPXW,Put,4/9/2020 0:00,2,3425,3125,35,-0.81,0.7,1,0,,,2765,70,1050000,0.002633333,No,1057447,1060212,Yes,-0.0305,0.3136,3578.03,3426.96,26.67,30.35
4/9/2020 15:30,8/9/2020 16:00,SPXW,Put,8/9/2020 0:00,4,3175,2875,35,-1.41,1.2,1.7,0,,,4865,70,1050000,0.004633333,No,1060212,1065077,Yes,-0.0298,0.4239,3451.14,3331.84,29.74,31.86
8/9/2020 15:30,9/9/2020 16:00,SPXW,Put,9/9/2020 0:00,1,3175,2875,36,-0.98,0.85,1.2,0,,,3456,72,1080000,0.0032,No,1065077,1068533,Yes,-0.0303,0.5408,3350.37,3398.96,31.48,29.14
9/9/2020 15:30,11/9/2020 16:00,SPXW,Put,11/9/2020 0:00,2,3225,2925,36,-1.09,1,1.25,0,,,3852,72,1080000,0.003566667,No,1068533,1072385,Yes,-0.0307,0.4291,3422.43,3340.97,28.2,26.63
11/9/2020 15:30,14/9/2020 16:00,SPXW,Put,14/9/2020 0:00,3,3200,2900,36,-0.89,0.8,1.05,0,,,3132,72,1080000,0.0029,No,1072385,1075517,Yes,-0.0309,0.2638,3347.16,3383.54,26.71,25.65
14/9/2020 15:30,16/9/2020 16:00,SPXW,Put,16/9/2020 0:00,2,3200,2900,36,-0.96,0.9,1.1,0,,,3384,72,1080000,0.003133333,No,1075517,1078901,Yes,-0.0299,0.3968,3381.81,3385.49,25.82,26.08
16/9/2020 15:30,18/9/2020 16:00,SPXW,Put,18/9/2020 0:00,2,3210,2910,36,-0.94,0.85,1.1,0,,,3312,72,1080000,0.003066667,No,1078901,1082213,Yes,-0.0296,0.4008,3395.13,3319.47,25.8,25.81
18/9/2020 15:30,21/9/2020 16:00,SPXW,Put,21/9/2020 0:00,3,3185,2880,35,-0.79,0.7,0.95,0,,,2695,70,1067500,0.00252459,No,1082213,1084908,Yes,-0.0296,0.2498,3324.06,3281.06,25.98,27.55
21/9/2020 15:30,23/9/2020 16:00,SPXW,Put,23/9/2020 0:00,2,3090,2800,37,-0.94,0.85,1.1,0,,,3404,74,1073000,0.003172414,No,1084908,1088312,Yes,-0.0294,0.3843,3261.63,3236.92,28.23,29.11
23/9/2020 15:30,25/9/2020 16:00,SPXW,Put,25/9/2020 0:00,2,3075,2775,36,-0.96,0.9,1.1,0,,,3384,72,1080000,0.003133333,No,1088312,1091696,Yes,-0.0297,0.3901,3248.05,3298.46,28.86,26.02
25/9/2020 15:30,28/9/2020 16:00,SPXW,Put,28/9/2020 0:00,3,3180,2880,36,-0.66,0.6,0.8,0,,,2304,72,1080000,0.002133333,No,1091696,1094000,Yes,-0.0288,0.2226,3304.19,3351.6,26.44,26.43
28/9/2020 15:30,30/9/2020 16:00,SPXW,Put,30/9/2020 0:00,2,3220,2920,36,-0.76,0.7,0.9,0,,,2664,72,1080000,0.002466667,No,1094000,1096664,Yes,-0.0306,0.2992,3357.24,3363,26.51,25.81
30/9/2020 15:30,2/10/2020 16:00,SPXW,Put,2/10/2020 0:00,2,3180,2880,37,-0.99,0.9,1.15,0,,,3589,74,1110000,0.003233333,No,1096664,1100253,Yes,-0.0302,0.3794,3352.93,3348.42,26.08,27.46
2/10/2020 15:30,5/10/2020 16:00,SPXW,Put,5/10/2020 0:00,3,3220,2920,37,-0.81,0.75,0.95,0,,,2923,74,1110000,0.002633333,No,1100253,1103176,Yes,-0.0301,0.2493,3360.4,3408.6,27.13,28.08
5/10/2020 15:30,7/10/2020 16:00,SPXW,Put,7/10/2020 0:00,2,3270,2970,37,-0.76,0.7,0.9,0,,,2738,74,1110000,0.002466667,No,1103176,1105914,Yes,-0.0291,0.2954,3408.46,3419.44,28.09,28.18
7/10/2020 15:30,9/10/2020 16:00,SPXW,Put,9/10/2020 0:00,2,3280,2980,37,-0.79,0.7,0.95,0,,,2849,74,1110000,0.002566667,No,1105914,1108763,Yes,-0.0291,0.3017,3423.3,3477.14,28.28,24.82
9/10/2020 15:30,12/10/2020 16:00,SPXW,Put,12/10/2020 0:00,3,3370,3070,37,-0.56,0.55,0.65,0,,,1998,74,1110000,0.0018,No,1108763,1110761,Yes,-0.028,0.1822,3477.71,3534.22,25.03,25.18
12/10/2020 15:30,14/10/2020 16:00,SPXW,Put,14/10/2020 0:00,2,3390,3090,37,-0.84,0.75,1,0,,,3034,74,1110000,0.002733333,No,1110761,1113795,Yes,-0.0299,0.3153,3542.97,3488.67,25.24,26.37
14/10/2020 15:30,16/10/2020 16:00,SPXW,Put,16/10/2020 0:00,2,3350,3050,37,-0.78,0.75,0.9,0,,,2812,74,1110000,0.002533333,No,1113795,1116607,Yes,-0.0304,0.3059,3496.09,3483.81,26.22,26.85
16/10/2020 15:30,19/10/2020 16:00,SPXW,Put,19/10/2020 0:00,3,3390,3090,37,-0.61,0.55,0.75,0,,,2183,74,1110000,0.001966667,No,1116607,1118790,Yes,-0.0305,0.1838,3497.17,3426.92,26.5,29.28
19/10/2020 15:30,21/10/2020 16:00,SPXW,Put,21/10/2020 0:00,2,3270,2970,37,-0.86,0.8,1,0,,,3108,74,1110000,0.0028,No,1118790,1121898,Yes,-0.0296,0.3381,3428.53,3435.56,29.38,28.73
21/10/2020 15:30,23/10/2020 16:00,SPXW,Put,23/10/2020 0:00,2,3320,3020,37,-0.71,0.65,0.85,0,,,2553,74,1110000,0.0023,No,1121898,1124451,Yes,-0.0285,0.2801,3454.37,3465.39,28.51,27.32
23/10/2020 15:30,26/10/2020 16:00,SPXW,Put,26/10/2020 0:00,3,3360,3060,37,-0.54,0.45,0.7,0,,,1924,74,1110000,0.001733333,No,1124451,1126375,Yes,-0.0297,0.1713,3459.76,3400.97,27.45,32.56
26/10/2020 15:30,28/10/2020 16:00,SPXW,Put,28/10/2020 0:00,2,3220,2925,38,-0.86,0.8,1,0,,,3192,76,1121000,0.002847458,No,1126375,1129567,Yes,-0.0303,0.3732,3391.85,3271.03,32.85,40.7
28/10/2020 15:30,30/10/2020 16:00,SPXW,Put,30/10/2020 0:00,2,3060,2760,38,-1.26,1.15,1.45,0,,,4712,76,1140000,0.004133333,No,1129567,1134279,Yes,-0.0296,0.5338,3297.26,3269.96,38.29,38.06
30/10/2020 15:30,2/11/2020 16:00,SPXW,Put,2/11/2020 0:00,3,2970,2675,38,-1.56,1.4,1.8,0,,,5852,76,1121000,0.005220339,No,1134279,1140131,Yes,-0.0299,0.5186,3245.69,3310.24,38.73,37.27
2/11/2020 15:30,4/11/2020 16:00,SPXW,Put,4/11/2020 0:00,2,2925,2625,38,-1.84,1.65,2.1,0,,,6916,76,1140000,0.006066667,No,1140131,1147047,Yes,-0.0297,0.8856,3306.39,3443.44,37.37,29.78
4/11/2020 15:30,6/11/2020 16:00,SPXW,Put,6/11/2020 0:00,2,3175,2875,38,-1.29,1.2,1.45,0,,,4826,76,1140000,0.004233333,No,1147047,1151873,Yes,-0.0299,0.5857,3445.27,3509.44,29.95,24.89
6/11/2020 15:30,9/11/2020 16:00,SPXW,Put,9/11/2020 0:00,3,3345,3045,38,-0.94,0.85,1.1,0,,,3496,76,1140000,0.003066667,No,1151873,1155369,Yes,-0.0297,0.2758,3506.78,3550.5,25.35,25.7
9/11/2020 15:30,11/11/2020 16:00,SPXW,Put,11/11/2020 0:00,2,3410,3110,39,-0.99,0.9,1.15,0,,,3783,78,1170000,0.003233333,No,1155369,1159152,Yes,-0.0305,0.3661,3588.07,3572.66,24.06,23.58
11/11/2020 15:30,13/11/2020 16:00,SPXW,Put,13/11/2020 0:00,2,3405,3105,39,-0.83,0.8,0.95,0,,,3159,78,1170000,0.0027,No,1159152,1162311,Yes,-0.0302,0.3177,3560.61,3585.15,24.09,23.13
13/11/2020 15:30,16/11/2020 16:00,SPXW,Put,16/11/2020 0:00,3,3450,3150,39,-0.76,0.7,0.9,0,,,2886,78,1170000,0.002466667,No,1162311,1165197,Yes,-0.0308,0.2217,3581.76,3626.91,22.94,22.69
16/11/2020 15:30,18/11/2020 16:00,SPXW,Put,18/11/2020 0:00,2,3465,3165,39,-0.76,0.7,0.9,0,,,2886,78,1170000,0.002466667,No,1165197,1168083,Yes,-0.03,0.2991,3613.58,3567.79,23.07,23.7
18/11/2020 15:30,20/11/2020 16:00,SPXW,Put,20/11/2020 0:00,2,3450,3150,39,-0.78,0.7,0.95,0,,,2964,78,1170000,0.002533333,No,1168083,1171047,Yes,-0.0307,0.2942,3594.41,3557.54,22.92,23.53
20/11/2020 15:30,23/11/2020 16:00,SPXW,Put,23/11/2020 0:00,3,3450,3150,39,-0.58,0.55,0.7,0,,,2184,78,1170000,0.001866667,No,1171047,1173231,Yes,-0.0295,0.1879,3563.6,3577.59,22.74,22.64
23/11/2020 15:30,25/11/2020 16:00,SPXW,Put,25/11/2020 0:00,2,3465,3165,39,-0.69,0.6,0.85,0,,,2613,78,1170000,0.002233333,No,1173231,1175844,Yes,-0.0312,0.2365,3580.37,3629.65,22.63,21.22
25/11/2020 15:30,27/11/2020 16:00,SPXW,Put,27/11/2020 0:00,2,3555,3255,39,-0.43,0.4,0.55,0,,,1599,78,1170000,0.001366667,No,1175844,1177443,Yes,-0.0305,0.1546,3632.97,3638.35,21.19,20.84
27/11/2020 15:30,30/11/2020 16:00,SPXW,Put,30/11/2020 0:00,3,3535,3235,39,-0.54,0.45,0.7,0,,,2028,78,1170000,0.001733333,No,1177443,1179471,Yes,-0.0288,0.1655,3638.35,3621.63,20.84,20.75
30/11/2020 15:30,2/12/2020 16:00,SPXW,Put,2/12/2020 0:00,2,3480,3180,39,-0.66,0.6,0.8,0,,,2496,78,1170000,0.002133333,No,1179471,1181967,Yes,-0.0297,0.2713,3614.86,3669.01,21.1,21.24
2/12/2020 15:30,4/12/2020 16:00,SPXW,Put,4/12/2020 0:00,2,3530,3230,39,-0.71,0.65,0.85,0,,,2691,78,1170000,0.0023,No,1181967,1184658,Yes,-0.0297,0.2674,3665.42,3699.12,20.96,20.62
4/12/2020 15:30,7/12/2020 16:00,SPXW,Put,7/12/2020 0:00,3,3590,3290,39,-0.56,0.5,0.7,0,,,2106,78,1170000,0.0018,No,1184658,1186764,Yes,-0.0304,0.1625,3690.37,3691.96,20.77,21.22
7/12/2020 15:30,9/12/2020 16:00,SPXW,Put,9/12/2020 0:00,2,3575,3275,40,-0.56,0.5,0.7,0,,,2160,80,1200000,0.0018,No,1186764,1188924,Yes,-0.0294,0.222,3688.68,3672.82,21.41,21.91
9/12/2020 15:30,11/12/2020 16:00,SPXW,Put,11/12/2020 0:00,2,3505,3205,40,-0.71,0.65,0.85,0,,,2760,80,1200000,0.0023,No,1188924,1191684,Yes,-0.0299,0.3126,3661.68,3663.46,22.75,23.48
11/12/2020 15:30,14/12/2020 16:00,SPXW,Put,14/12/2020 0:00,3,3520,3220,40,-0.71,0.65,0.85,0,,,2760,80,1200000,0.0023,No,1191684,1194444,Yes,-0.03,0.2298,3661.28,3647.49,23.08,24.65
14/12/2020 15:30,16/12/2020 16:00,SPXW,Put,16/12/2020 0:00,2,3425,3125,40,-1.04,0.95,1.2,0,,,4080,80,1200000,0.0034,No,1194444,1198524,Yes,-0.0303,0.4828,3662.9,3701.17,23.94,22.57
16/12/2020 15:30,18/12/2020 16:00,SPXW,Put,18/12/2020 0:00,2,3525,3225,40,-0.81,0.75,0.95,0,,,3160,80,1200000,0.002633333,No,1198524,1201684,Yes,-0.0304,0.3628,3707.76,3709.41,22.63,21.7
18/12/2020 15:30,21/12/2020 16:00,SPXW,Put,21/12/2020 0:00,3,3500,3200,40,-0.98,0.95,1.1,0,,,3840,80,1200000,0.0032,No,1201684,1205524,Yes,-0.0297,0.3071,3687.65,3694.92,23.6,24.93
21/12/2020 15:30,23/12/2020 16:00,SPXW,Put,23/12/2020 0:00,2,3515,3210,40,-0.91,0.85,1.05,0,,,3560,80,1220000,0.002918033,No,1205524,1209084,Yes,-0.0292,0.3506,3692.56,3690.01,25.05,23.02
23/12/2020 15:30,24/12/2020 16:00,SPXW,Put,24/12/2020 0:00,1,3630,3330,40,-0.38,0.35,0.5,0,,,1440,80,1200000,0.0012,No,1209084,1210524,Yes,-0.0297,0.1974,3702.61,3703.06,22.42,21.53
24/12/2020 15:30,28/12/2020 16:00,SPXW,Put,28/12/2020 0:00,4,3590,3290,40,-0.66,0.6,0.8,0,,,2560,80,1200000,0.002133333,No,1210524,1213084,Yes,-0.0304,0.1553,3703.06,3735.36,21.53,21.79
28/12/2020 15:30,30/12/2020 16:00,SPXW,Put,30/12/2020 0:00,2,3620,3320,40,-0.63,0.6,0.75,0,,,2440,80,1200000,0.002033333,No,1213084,1215524,Yes,-0.0303,0.2267,3735.9,3732.04,21.52,22.69
30/12/2020 15:30,31/12/2020 16:00,SPXW,Put,31/12/2020 0:00,1,3625,3325,41,-0.56,0.5,0.7,0,,,2214,82,1230000,0.0018,No,1215524,1217738,Yes,-0.0291,0.2892,3732.11,3756.07,23.06,22.51
4/1/2021 9:31,6/1/2021 16:00,SPXW,Put,6/1/2021 0:00,2,3530,3230,41,-1.28,1.15,1.5,0,,,5166,82,1230000,0.0042,No,1217738,1222904,Yes,-0.0301,0.4389,3766.65,3726.86,23.55,25.96
6/1/2021 15:30,8/1/2021 16:00,SPXW,Put,8/1/2021 0:00,2,3495,3195,41,-1.29,1.15,1.5,0,,,5207,82,1230000,0.004233333,No,1222904,1228111,Yes,-0.0302,0.5163,3756.18,3803.79,25.99,21.52
8/1/2021 15:30,11/1/2021 16:00,SPXW,Put,11/1/2021 0:00,3,3685,3380,40,-0.79,0.7,0.95,0,,,3080,80,1220000,0.00252459,No,1228111,1231191,Yes,-0.0309,0.2079,3816.92,3824.68,21.77,24.31
11/1/2021 15:30,13/1/2021 16:00,SPXW,Put,13/1/2021 0:00,2,3620,3320,41,-0.91,0.85,1.05,0,,,3649,82,1230000,0.002966667,No,1231191,1234840,Yes,-0.0305,0.3395,3795.35,3801.19,24.61,22.23
13/1/2021 15:30,15/1/2021 16:00,SPXW,Put,15/1/2021 0:00,2,3650,3350,41,-0.79,0.75,0.9,0,,,3157,82,1230000,0.002566667,No,1234840,1237997,Yes,-0.0301,0.3062,3809.95,3768.25,22.33,23.8
15/1/2021 15:30,19/1/2021 16:00,SPXW,Put,19/1/2021 0:00,4,3600,3300,41,-0.88,0.85,1,0,,,3526,82,1230000,0.002866667,No,1237997,1241523,Yes,-0.0302,0.2448,3776.88,3798.91,23.6,22.92
19/1/2021 15:30,20/1/2021 16:00,SPXW,Put,20/1/2021 0:00,1,3690,3390,41,-0.56,0.5,0.7,0,,,2214,82,1230000,0.0018,No,1241523,1243737,Yes,-0.03,0.2951,3800.83,3851.85,23.06,21.48
20/1/2021 15:30,22/1/2021 16:00,SPXW,Put,22/1/2021 0:00,2,3710,3410,41,-0.71,0.65,0.85,0,,,2829,82,1230000,0.0023,No,1243737,1246566,Yes,-0.0294,0.2728,3855.39,3841.47,21.51,21.49
22/1/2021 15:30,25/1/2021 16:00,SPXW,Put,25/1/2021 0:00,3,3740,3440,42,-0.51,0.45,0.65,0,,,2058,84,1260000,0.001633333,No,1246566,1248624,Yes,-0.0284,0.1684,3850.76,3855.36,21.36,23.34
25/1/2021 15:30,27/1/2021 16:00,SPXW,Put,27/1/2021 0:00,2,3665,3360,41,-0.86,0.8,1,0,,,3444,82,1250500,0.002754098,No,1248624,1252068,Yes,-0.0302,0.3386,3842.45,3750.77,23.99,32.53
27/1/2021 15:30,29/1/2021 16:00,SPXW,Put,29/1/2021 0:00,2,3395,3095,42,-1.63,1.5,1.85,0,,,6762,84,1260000,0.005366667,No,1252068,1258830,Yes,-0.03,0.7075,3746.06,3714.24,32.11,32.42
29/1/2021 15:30,1/2/2021 16:00,SPXW,Put,1/2/2021 0:00,3,3495,3190,41,-1.41,1.25,1.65,0,,,5699,82,1250500,0.004557377,No,1258830,1264529,Yes,-0.0304,0.3868,3731.89,3773.86,31.09,29.57
1/2/2021 15:30,3/2/2021 16:00,SPXW,Put,3/2/2021 0:00,2,3565,3260,41,-1.16,1.1,1.3,0,,,4674,82,1250500,0.003737705,No,1264529,1269203,Yes,-0.0304,0.4151,3777.16,3830.17,29.85,23.66
3/2/2021 15:30,5/2/2021 16:00,SPXW,Put,5/2/2021 0:00,2,3670,3370,42,-0.91,0.85,1.05,0,,,3738,84,1260000,0.002966667,No,1269203,1272941,Yes,-0.0298,0.3146,3835.75,3886.83,23.57,21.03
5/2/2021 15:30,8/2/2021 16:00,SPXW,Put,8/2/2021 0:00,3,3780,3480,42,-0.56,0.55,0.65,0,,,2268,84,1260000,0.0018,No,1272941,1275209,Yes,-0.0309,0.1573,3882.28,3915.59,21.06,21.33
8/2/2021 15:30,10/2/2021 16:00,SPXW,Put,10/2/2021 0:00,2,3780,3480,43,-0.61,0.55,0.75,0,,,2537,86,1290000,0.001966667,No,1275209,1277746,Yes,-0.0288,0.2297,3905.39,3909.88,21.51,22.2
10/2/2021 15:30,12/2/2021 16:00,SPXW,Put,12/2/2021 0:00,2,3755,3455,43,-0.81,0.75,0.95,0,,,3397,86,1290000,0.002633333,No,1277746,1281143,Yes,-0.0298,0.2945,3913.39,3934.83,21.95,20.07
12/2/2021 15:30,16/2/2021 16:00,SPXW,Put,16/2/2021 0:00,4,3815,3515,43,-0.61,0.55,0.75,0,,,2537,86,1290000,0.001966667,No,1281143,1283680,Yes,-0.0308,0.1413,3922.76,3932.59,20.08,21.38
16/2/2021 15:30,17/2/2021 16:00,SPXW,Put,17/2/2021 0:00,1,3830,3530,43,-0.54,0.45,0.7,0,,,2236,86,1290000,0.001733333,No,1283680,1285916,Yes,-0.0304,0.2703,3935.36,3931.33,21.17,21.39
17/2/2021 15:30,19/2/2021 16:00,SPXW,Put,19/2/2021 0:00,2,3775,3475,43,-0.66,0.6,0.8,0,,,2752,86,1290000,0.002133333,No,1285916,1288668,Yes,-0.0292,0.2843,3929.04,3906.71,21.42,21.74
19/2/2021 15:30,22/2/2021 16:00,SPXW,Put,22/2/2021 0:00,3,3810,3510,43,-0.59,0.5,0.75,0,,,2451,86,1290000,0.0019,No,1288668,1291119,Yes,-0.0307,0.1576,3913.38,3876.5,21.69,23.55
22/2/2021 15:30,24/2/2021 16:00,SPXW,Put,24/2/2021 0:00,2,3740,3440,43,-0.76,0.7,0.9,0,,,3182,86,1290000,0.002466667,No,1291119,1294301,Yes,-0.0296,0.2688,3883.5,3925.43,22.96,21.4
24/2/2021 15:30,26/2/2021 16:00,SPXW,Put,26/2/2021 0:00,2,3780,3480,43,-0.81,0.75,0.95,0,,,3397,86,1290000,0.002633333,No,1294301,1297698,Yes,-0.0306,0.2698,3925.16,3811.15,21.64,26.94
26/2/2021 15:30,1/3/2021 16:00,SPXW,Put,1/3/2021 0:00,3,3625,3325,43,-1.16,1.05,1.35,0,,,4902,86,1290000,0.0038,No,1297698,1302600,Yes,-0.0303,0.3249,3830.79,3901.82,27.04,23.22
1/3/2021 15:30,3/3/2021 16:00,SPXW,Put,3/3/2021 0:00,2,3720,3420,43,-0.99,0.95,1.1,0,,,4171,86,1290000,0.003233333,No,1302600,1306771,Yes,-0.0292,0.3525,3908.69,3819.72,23.25,26.41
3/3/2021 15:30,5/3/2021 16:00,SPXW,Put,5/3/2021 0:00,2,3630,3330,44,-1.21,1.15,1.35,0,,,5236,88,1320000,0.003966667,No,1306771,1312007,Yes,-0.0304,0.3946,3834.88,3841.94,25.9,24.66
5/3/2021 15:30,8/3/2021 16:00,SPXW,Put,8/3/2021 0:00,3,3665,3360,43,-1.01,0.9,1.2,0,,,4257,86,1311500,0.003245902,No,1312007,1316264,Yes,-0.0304,0.2701,3837.26,3821.35,24.8,25.88
8/3/2021 15:30,10/3/2021 16:00,SPXW,Put,10/3/2021 0:00,2,3630,3330,44,-1.06,1,1.2,0,,,4576,88,1320000,0.003466667,No,1316264,1320840,Yes,-0.0288,0.3897,3835.15,3898.81,25.6,22.73
10/3/2021 15:30,12/3/2021 16:00,SPXW,Put,12/3/2021 0:00,2,3745,3445,44,-0.88,0.85,1,0,,,3784,88,1320000,0.002866667,No,1320840,1324624,Yes,-0.0297,0.2957,3904.53,3943.34,22.65,20.82
12/3/2021 15:30,15/3/2021 16:00,SPXW,Put,15/3/2021 0:00,3,3835,3535,44,-0.56,0.5,0.7,0,,,2376,88,1320000,0.0018,No,1324624,1327000,Yes,-0.0302,0.1548,3937.34,3968.94,20.88,19.96
15/3/2021 15:30,17/3/2021 16:00,SPXW,Put,17/3/2021 0:00,2,3820,3520,44,-0.71,0.65,0.85,0,,,3036,88,1320000,0.0023,No,1327000,1330036,Yes,-0.0307,0.2401,3950.15,3974.12,20.41,19.32
17/3/2021 15:30,19/3/2021 16:00,SPXW,Put,19/3/2021 0:00,2,3825,3525,44,-0.74,0.65,0.9,0,,,3168,88,1320000,0.0024,No,1330036,1333204,Yes,-0.0295,0.2709,3973.98,3913.1,19.52,20.65
19/3/2021 15:30,22/3/2021 16:00,SPXW,Put,22/3/2021 0:00,3,3810,3510,44,-0.59,0.5,0.75,0,,,2508,88,1320000,0.0019,No,1333204,1335712,Yes,-0.0303,0.1713,3922.81,3940.59,20.29,19.04
22/3/2021 15:30,24/3/2021 16:00,SPXW,Put,24/3/2021 0:00,2,3820,3520,45,-0.68,0.65,0.8,0,,,2970,90,1350000,0.0022,No,1335712,1338682,Yes,-0.0301,0.2312,3945.81,3889.14,19.36,21.33
24/3/2021 15:30,26/3/2021 16:00,SPXW,Put,26/3/2021 0:00,2,3765,3465,45,-0.81,0.75,0.95,0,,,3555,90,1350000,0.002633333,No,1338682,1342237,Yes,-0.0308,0.2694,3908.37,3974.54,20.7,18.99
26/3/2021 15:30,29/3/2021 16:00,SPXW,Put,29/3/2021 0:00,3,3805,3500,44,-0.71,0.65,0.85,0,,,3036,88,1342000,0.002262295,No,1342237,1345273,Yes,-0.0293,0.2071,3943.3,3971.09,19.7,20.92
29/3/2021 15:30,31/3/2021 16:00,SPXW,Put,31/3/2021 0:00,2,3805,3505,45,-0.88,0.85,1,0,,,3870,90,1350000,0.002866667,No,1345273,1349143,Yes,-0.0296,0.3205,3980.76,3972.89,20.68,18.96
31/3/2021 15:30,1/4/2021 16:00,SPXW,Put,1/4/2021 0:00,1,3895,3595,45,-0.53,0.5,0.65,0,,,2295,90,1350000,0.0017,No,1349143,1351438,Yes,-0.0308,0.2335,3986.81,4019.87,19.05,17.32
1/4/2021 15:30,5/4/2021 16:00,SPXW,Put,5/4/2021 0:00,4,3915,3615,45,-0.46,0.4,0.6,0,,,1980,90,1350000,0.001466667,No,1351438,1353418,Yes,-0.0283,0.1193,4010.31,4077.91,17.83,17.87
5/4/2021 15:30,7/4/2021 16:00,SPXW,Put,7/4/2021 0:00,2,3950,3650,45,-0.71,0.7,0.8,0,,,3105,90,1350000,0.0023,No,1353418,1356523,Yes,-0.0311,0.2219,4074.09,4079.95,18.13,17.28
7/4/2021 15:30,9/4/2021 16:00,SPXW,Put,9/4/2021 0:00,2,3960,3660,45,-0.56,0.5,0.7,0,,,2430,90,1350000,0.0018,No,1356523,1358953,Yes,-0.0294,0.2004,4073.99,4128.8,17.39,16.65
9/4/2021 15:30,12/4/2021 16:00,SPXW,Put,12/4/2021 0:00,3,4025,3725,45,-0.43,0.4,0.55,0,,,1845,90,1350000,0.001366667,No,1358953,1360798,Yes,-0.0286,0.1325,4117.89,4127.99,16.55,16.87
12/4/2021 15:30,14/4/2021 16:00,SPXW,Put,14/4/2021 0:00,2,4015,3715,45,-0.48,0.45,0.6,0,,,2070,90,1350000,0.001533333,No,1360798,1362868,Yes,-0.029,0.1873,4122.73,4124.66,17.09,17.26
14/4/2021 15:30,16/4/2021 16:00,SPXW,Put,16/4/2021 0:00,2,4005,3705,45,-0.69,0.6,0.85,0,,,3015,90,1350000,0.002233333,No,1362868,1365883,Yes,-0.0305,0.224,4131.77,4185.47,17.15,16.2
16/4/2021 15:30,19/4/2021 16:00,SPXW,Put,19/4/2021 0:00,3,4110,3810,46,-0.43,0.4,0.55,0,,,1886,92,1380000,0.001366667,No,1365883,1367769,Yes,-0.0306,0.1096,4187.27,4163.26,16.35,17.48
19/4/2021 15:30,21/4/2021 16:00,SPXW,Put,21/4/2021 0:00,2,4035,3735,46,-0.66,0.6,0.8,0,,,2944,92,1380000,0.002133333,No,1367769,1370713,Yes,-0.031,0.2122,4155.76,4173.42,18.08,17.17
21/4/2021 15:30,23/4/2021 16:00,SPXW,Put,23/4/2021 0:00,2,4060,3760,46,-0.53,0.5,0.65,0,,,2346,92,1380000,0.0017,No,1370713,1373059,Yes,-0.03,0.1793,4163.64,4180.17,17.18,17.02
23/4/2021 15:30,26/4/2021 16:00,SPXW,Put,26/4/2021 0:00,3,4115,3815,46,-0.39,0.35,0.5,0,,,1702,92,1380000,0.001233333,No,1373059,1374761,Yes,-0.0303,0.1054,4189.61,4187.62,16.9,17.76
26/4/2021 15:30,28/4/2021 16:00,SPXW,Put,28/4/2021 0:00,2,4075,3775,46,-0.51,0.45,0.65,0,,,2254,92,1380000,0.001633333,No,1374761,1377015,Yes,-0.0286,0.1879,4185.09,4183.18,17.69,17.5
28/4/2021 15:30,30/4/2021 16:00,SPXW,Put,30/4/2021 0:00,2,4085,3785,46,-0.56,0.5,0.7,0,,,2484,92,1380000,0.0018,No,1377015,1379499,Yes,-0.0309,0.1847,4191.78,4181.17,17.28,18.63
30/4/2021 15:30,3/5/2021 16:00,SPXW,Put,3/5/2021 0:00,3,4090,3790,46,-0.51,0.45,0.65,0,,,2254,92,1380000,0.001633333,No,1379499,1381753,Yes,-0.0314,0.1379,4185.8,4192.66,18.66,18.28
3/5/2021 15:30,5/5/2021 16:00,SPXW,Put,5/5/2021 0:00,2,4075,3775,46,-0.58,0.55,0.7,0,,,2576,92,1380000,0.001866667,No,1381753,1384329,Yes,-0.0292,0.2108,4197.25,4167.59,18.19,19.02
5/5/2021 15:30,7/5/2021 16:00,SPXW,Put,7/5/2021 0:00,2,4025,3725,46,-0.56,0.55,0.65,0,,,2484,92,1380000,0.0018,No,1384329,1386813,Yes,-0.0294,0.2453,4167.92,4232.6,19.09,16.81
7/5/2021 15:30,10/5/2021 16:00,SPXW,Put,10/5/2021 0:00,3,4140,3840,46,-0.46,0.4,0.6,0,,,2024,92,1380000,0.001466667,No,1386813,1388837,Yes,-0.0308,0.1342,4235.7,4188.43,16.89,19.28
10/5/2021 15:30,12/5/2021 16:00,SPXW,Put,12/5/2021 0:00,2,4045,3740,46,-0.76,0.7,0.9,0,,,3404,92,1403000,0.00242623,No,1388837,1392241,Yes,-0.0307,0.2773,4204.46,4063.04,18.47,27.68
12/5/2021 15:30,14/5/2021 16:00,SPXW,Put,14/5/2021 0:00,2,3760,3460,46,-1.33,1.25,1.5,0,,,6026,92,1380000,0.004366667,No,1392241,1398267,Yes,-0.0298,0.5611,4066.16,4173.85,27.69,18.94
